トークン	品詞
年に	['名詞', '助詞']
ている	['助詞', '動詞']
日に	['名詞', '助詞']
となった	['助詞', '動詞', '助動詞']
となる	['助詞', '動詞']
がある	['助詞', '動詞']
月に	['名詞', '助詞']
ていた	['助詞', '動詞', '助動詞']
年には	['名詞', '助詞', '助詞']
年から	['名詞', '助詞']
後に	['名詞', '助詞']
となっている	['助詞', '動詞', '助詞', '動詞']
ており	['助詞', '動詞']
にある	['助詞', '動詞']
年の	['名詞', '助詞']
これは	['名詞', '助詞']
があり	['助詞', '動詞']
現在の	['名詞', '助詞']
日本の	['名詞', '助詞']
人の	['名詞', '助詞']
になった	['助詞', '動詞', '助動詞']
多くの	['名詞', '助詞']
とする	['助詞', '動詞']
になる	['助詞', '動詞']
を持つ	['助詞', '動詞']
他の	['名詞', '助詞']
と呼ばれる	['助詞', '動詞', '動詞']
日の	['名詞', '助詞']
を行う	['助詞', '動詞']
的に	['名詞', '助詞']
当時の	['名詞', '助詞']
ことから	['名詞', '助詞']
のため	['助詞', '名詞']
を経て	['助詞', '動詞', '助詞']
彼は	['名詞', '助詞']
があった	['助詞', '動詞', '助動詞']
ように	['名詞', '助詞']
ために	['名詞', '助詞']
後の	['名詞', '助詞']
のために	['助詞', '名詞', '助詞']
とされる	['助詞', '動詞', '動詞']
もある	['助詞', '動詞']
月には	['名詞', '助詞', '助詞']
を行った	['助詞', '動詞', '助動詞']
年まで	['名詞', '助詞']
ことを	['名詞', '助詞']
を受け	['助詞', '動詞']
これらの	['名詞', '助詞']
とした	['助詞', '動詞', '助動詞']
のような	['助詞', '名詞', '助動詞']
ことが	['名詞', '助詞']
日には	['名詞', '助詞', '助詞']
現在は	['名詞', '助詞']
主に	['名詞', '助詞']
を含む	['助詞', '動詞']
日から	['名詞', '助詞']
最初の	['名詞', '助詞']
人が	['名詞', '助詞']
の中で	['助詞', '名詞', '助詞']
彼の	['名詞', '助詞']
を受けた	['助詞', '動詞', '助動詞']
のうち	['助詞', '名詞']
中に	['名詞', '助詞']
になっている	['助詞', '動詞', '助詞', '動詞']
を務めた	['助詞', '動詞', '助動詞']
になり	['助詞', '動詞']
初の	['名詞', '助詞']
のように	['助詞', '名詞', '助詞']
を行い	['助詞', '動詞']
当初は	['名詞', '助詞']
のある	['助詞', '動詞']
月から	['名詞', '助詞']
にあった	['助詞', '動詞', '助動詞']
によれば	['助詞', '動詞', '助詞']
を中心に	['助詞', '名詞', '助詞']
等の	['名詞', '助詞']
上の	['名詞', '助詞']
っていた	['助詞', '動詞', '助動詞']
戦で	['名詞', '助詞']
としている	['助詞', '動詞', '助詞', '動詞']
これを	['名詞', '助詞']
中の	['名詞', '助詞']
の一部	['助詞', '名詞']
によると	['助詞', '動詞', '助詞']
内の	['名詞', '助詞']
が行われた	['助詞', '動詞', '動詞', '助動詞']
に伴い	['助詞', '動詞']
用の	['名詞', '助詞']
とし	['助詞', '動詞']
家の	['名詞', '助詞']
時の	['名詞', '助詞']
市の	['名詞', '助詞']
ていたが	['助詞', '動詞', '助動詞', '助詞']
ことができる	['名詞', '助詞', '動詞']
ようになった	['名詞', '助詞', '動詞', '助動詞']
前に	['名詞', '助詞']
自身の	['名詞', '助詞']
日本では	['名詞', '助詞', '助詞']
時代の	['名詞', '助詞']
年より	['名詞', '助詞']
を受けて	['助詞', '動詞', '助詞']
のための	['助詞', '名詞', '助詞']
以上の	['名詞', '助詞']
とされている	['助詞', '動詞', '動詞', '助詞', '動詞']
に位置する	['助詞', '名詞', '動詞']
てきた	['助詞', '動詞', '助動詞']
こともある	['名詞', '助詞', '動詞']
にあたる	['助詞', '動詞']
最後の	['名詞', '助詞']
以外の	['名詞', '助詞']
人は	['名詞', '助詞']
ことがある	['名詞', '助詞', '動詞']
上で	['名詞', '助詞']
後は	['名詞', '助詞']
もあり	['助詞', '動詞']
を見	['助詞', '動詞']
自分の	['名詞', '助詞']
者の	['名詞', '助詞']
ことは	['名詞', '助詞']
これが	['名詞', '助詞']
内に	['名詞', '助詞']
日まで	['名詞', '助詞']
歳で	['名詞', '助詞']
を行っている	['助詞', '動詞', '助詞', '動詞']
場合は	['名詞', '助詞']
系の	['名詞', '助詞']
軍の	['名詞', '助詞']
を務める	['助詞', '動詞']
一部の	['名詞', '助詞']
を持ち	['助詞', '動詞']
の研究	['助詞', '名詞']
全ての	['名詞', '助詞']
になると	['助詞', '動詞', '助詞']
線の	['名詞', '助詞']
者は	['名詞', '助詞']
非常に	['名詞', '助詞']
アメリカの	['名詞', '助詞']
者が	['名詞', '助詞']
間の	['名詞', '助詞']
前の	['名詞', '助詞']
の大	['助詞', '名詞']
それを	['名詞', '助詞']
複数の	['名詞', '助詞']
の一つ	['助詞', '名詞']
名は	['名詞', '助詞']
数は	['名詞', '助詞']
の娘	['助詞', '名詞']
をもって	['助詞', '動詞', '助詞']
上に	['名詞', '助詞']
で行われた	['助詞', '動詞', '動詞', '助動詞']
にあり	['助詞', '動詞']
別の	['名詞', '助詞']
の戦い	['助詞', '名詞']
と考えられている	['助詞', '動詞', '動詞', '助詞', '動詞']
を受ける	['助詞', '動詞']
が行われ	['助詞', '動詞', '動詞']
側の	['名詞', '助詞']
内で	['名詞', '助詞']
これにより	['名詞', '助詞']
新たに	['名詞', '助詞']
を務め	['助詞', '名詞']
いくつかの	['名詞', '助詞', '助詞']
と呼ぶ	['助詞', '動詞']
となっていた	['助詞', '動詞', '助詞', '動詞', '助動詞']
それは	['名詞', '助詞']
となって	['助詞', '動詞', '助詞']
出身の	['名詞', '助詞']
になって	['助詞', '動詞', '助詞']
を開始した	['助詞', '名詞', '動詞', '助動詞']
形で	['名詞', '助詞']
その後も	['名詞', '助詞']
国の	['名詞', '助詞']
いずれも	['名詞', '助詞']
がいる	['助詞', '動詞']
に入り	['助詞', '動詞']
以降は	['名詞', '助詞']
の開発	['助詞', '名詞']
イギリスの	['名詞', '助詞']
多数の	['名詞', '助詞']
最大の	['名詞', '助詞']
とその	['名詞', '助詞']
たちは	['名詞', '助詞']
の後	['助詞', '名詞']
を結ぶ	['助詞', '動詞']
年にかけて	['名詞', '助詞']
のほか	['助詞', '名詞']
型の	['名詞', '助詞']
ごとに	['名詞', '助詞']
ていく	['助詞', '動詞']
の場合	['助詞', '名詞']
の間	['助詞', '名詞']
を得た	['助詞', '動詞', '助動詞']
のか	['名詞', '助詞']
現在では	['名詞', '助詞', '助詞']
当時は	['名詞', '助詞']
ことが多い	['名詞', '助詞', '形容詞']
子の	['名詞', '助詞']
のちに	['名詞', '助詞']
となっており	['助詞', '動詞', '助詞', '動詞']
てしまう	['助詞', '動詞']
唯一の	['名詞', '助詞']
を指す	['助詞', '動詞']
その後は	['名詞', '助詞']
にして	['助詞', '動詞', '助詞']
と言う	['助詞', '動詞']
世の	['名詞', '助詞']
のもの	['助詞', '名詞']
部の	['名詞', '助詞']
を示す	['助詞', '動詞']
こともあり	['名詞', '助詞', '動詞']
月まで	['名詞', '助詞']
独自の	['名詞', '助詞']
年代に	['名詞', '助詞']
軍は	['名詞', '助詞']
を意味する	['助詞', '名詞', '動詞']
に入る	['助詞', '動詞']
従来の	['名詞', '助詞']
際に	['名詞', '助詞']
中で	['名詞', '助詞']
もあった	['助詞', '動詞', '助動詞']
世は	['名詞', '助詞']
すべての	['名詞', '助詞']
の名	['助詞', '名詞']
とされた	['助詞', '動詞', '動詞', '助動詞']
の間に	['助詞', '名詞', '助詞']
ものは	['名詞', '助詞']
町の	['名詞', '助詞']
氏の	['名詞', '助詞']
らが	['名詞', '助詞']
とされ	['助詞', '動詞', '動詞']
次の	['名詞', '助詞']
の中心	['助詞', '名詞']
を取り	['助詞', '動詞']
を果たした	['助詞', '動詞', '助動詞']
に就任	['助詞', '名詞']
名の	['名詞', '助詞']
フランスの	['名詞', '助詞']
の結果	['助詞', '名詞']
を用いて	['助詞', '動詞', '助詞']
名が	['名詞', '助詞']
彼らは	['名詞', '助詞']
の中	['助詞', '名詞']
の歴史	['助詞', '名詞']
時代に	['名詞', '助詞']
を有する	['助詞', '動詞']
からなる	['助詞', '動詞']
ドイツの	['名詞', '助詞']
月より	['名詞', '助詞']
をする	['助詞', '動詞']
を始め	['助詞', '名詞']
初期の	['名詞', '助詞']
と対戦し	['助詞', '名詞', '動詞']
ことも	['名詞', '助詞']
の中に	['助詞', '名詞', '助詞']
に加え	['助詞', '動詞']
の存在	['助詞', '名詞']
を参照	['助詞', '名詞']
をはじめ	['助詞', '名詞']
年からは	['名詞', '助詞', '助詞']
それまで	['名詞', '助詞']
ようになる	['名詞', '助詞', '動詞']
派の	['名詞', '助詞']
彼女は	['名詞', '助詞']
日より	['名詞', '助詞']
大学の	['名詞', '助詞']
川の	['名詞', '助詞']
の影響	['助詞', '名詞']
製の	['名詞', '助詞']
の際に	['助詞', '名詞', '助詞']
その他の	['名詞', '助詞']
に入った	['助詞', '動詞', '助動詞']
の下	['助詞', '名詞']
のまま	['助詞', '名詞']
本の	['名詞', '助詞']
他に	['名詞', '助詞']
式の	['名詞', '助詞']
名を	['名詞', '助詞']
ここで	['名詞', '助詞']
と呼ばれ	['助詞', '動詞', '動詞']
それが	['名詞', '助詞']
通常の	['名詞', '助詞']
を用いた	['助詞', '動詞', '助動詞']
に生まれる	['助詞', '動詞']
に由来する	['助詞', '名詞', '動詞']
現在も	['名詞', '助詞']
に参加	['助詞', '名詞']
位の	['名詞', '助詞']
時は	['名詞', '助詞']
の一	['助詞', '名詞']
後も	['名詞', '助詞']
ことにより	['名詞', '助詞']
を使って	['助詞', '動詞', '助詞']
ときに	['名詞', '助詞']
ものが	['名詞', '助詞']
の子	['助詞', '名詞']
が行われる	['助詞', '動詞', '動詞']
島の	['名詞', '助詞']
と考えられる	['助詞', '動詞', '動詞']
度の	['名詞', '助詞']
正式に	['名詞', '助詞']
側に	['名詞', '助詞']
それぞれの	['名詞', '助詞']
の作品	['助詞', '名詞']
ていった	['助詞', '動詞', '助動詞']
ようになり	['名詞', '助詞', '動詞']
世紀の	['名詞', '助詞']
の息子	['助詞', '名詞']
のひとつ	['助詞', '名詞']
をした	['助詞', '動詞', '助動詞']
特定の	['名詞', '助詞']
自らの	['名詞', '助詞']
状の	['名詞', '助詞']
と述べている	['助詞', '動詞', '助詞', '動詞']
逆に	['名詞', '助詞']
地域の	['名詞', '助詞']
を除く	['助詞', '動詞']
をしている	['助詞', '動詞', '助詞', '動詞']
に登場する	['助詞', '名詞', '動詞']
に移籍	['助詞', '名詞']
に属する	['助詞', '動詞']
に参加した	['助詞', '名詞', '動詞', '助動詞']
地元の	['名詞', '助詞']
を超える	['助詞', '動詞']
これに	['名詞', '助詞']
州の	['名詞', '助詞']
スは	['名詞', '助詞']
場合には	['名詞', '助詞', '助詞']
を始めた	['助詞', '動詞', '助動詞']
場合もある	['名詞', '助詞', '動詞']
を得る	['助詞', '動詞']
たちが	['名詞', '助詞']
に至る	['助詞', '動詞']
監督の	['名詞', '助詞']
っており	['助詞', '名詞']
向けの	['名詞', '助詞']
自身が	['名詞', '助詞']
彼女の	['名詞', '助詞']
の下で	['助詞', '名詞', '助詞']
の場合は	['助詞', '名詞', '助詞']
に就任した	['助詞', '名詞', '動詞', '助動詞']
たちの	['名詞', '助詞']
社の	['名詞', '助詞']
の間で	['助詞', '名詞', '助詞']
に位置し	['助詞', '名詞', '動詞']
と呼ばれた	['助詞', '動詞', '動詞', '助動詞']
の一人	['助詞', '名詞', '名詞']
を描いた	['助詞', '動詞', '助動詞']
らの	['名詞', '助詞']
の世界	['助詞', '名詞']
間に	['名詞', '助詞']
を発表した	['助詞', '名詞', '動詞', '助動詞']
の使用	['助詞', '名詞']
を発表	['助詞', '名詞']
父の	['名詞', '助詞']
彼が	['名詞', '助詞']
を記録した	['助詞', '名詞', '動詞', '助動詞']
戦では	['名詞', '助詞', '助詞']
以下の	['名詞', '助詞']
を行っていた	['助詞', '動詞', '助詞', '動詞', '助動詞']
同様に	['名詞', '助詞']
を得て	['助詞', '動詞', '助詞']
子は	['名詞', '助詞']
人を	['名詞', '助詞']
人に	['名詞', '助詞']
をしていた	['助詞', '動詞', '助詞', '動詞', '助動詞']
最初に	['名詞', '助詞']
を求める	['助詞', '動詞']
の手	['助詞', '名詞']
も多く	['助詞', '名詞']
機の	['名詞', '助詞']
を目指す	['助詞', '動詞']
の建設	['助詞', '名詞']
が見られる	['助詞', '動詞', '動詞']
年代の	['名詞', '助詞']
を果たす	['助詞', '動詞']
が行われている	['助詞', '動詞', '動詞', '助詞', '動詞']
と思われる	['助詞', '動詞', '動詞']
ものを	['名詞', '助詞']
に変更	['助詞', '名詞']
の名前	['助詞', '名詞']
を作る	['助詞', '動詞']
に基づく	['助詞', '動詞']
形の	['名詞', '助詞']
てしまった	['助詞', '動詞', '助動詞']
以前は	['名詞', '助詞']
を持った	['助詞', '動詞', '助動詞']
のもと	['助詞', '名詞']
んでいる	['助詞', '動詞']
を持っている	['助詞', '動詞', '助詞', '動詞']
ものと	['名詞', '助詞']
らは	['名詞', '助詞']
状態で	['名詞', '助詞']
これらは	['名詞', '助詞']
個の	['名詞', '助詞']
性の	['名詞', '助詞']
といわれる	['助詞', '動詞', '動詞']
側は	['名詞', '助詞']
をもつ	['助詞', '動詞']
完全に	['名詞', '助詞']
政府は	['名詞', '助詞']
彼らの	['名詞', '助詞']
中国の	['名詞', '助詞']
を引き	['助詞', '動詞']
を使用する	['助詞', '名詞', '動詞']
を中心とした	['助詞', '名詞', '助詞', '動詞', '助動詞']
を担当した	['助詞', '名詞', '動詞', '助動詞']
こともあった	['名詞', '助詞', '動詞', '助動詞']
大学で	['名詞', '助詞']
以前の	['名詞', '助詞']
が必要	['助詞', '名詞']
先に	['名詞', '助詞']
に向けて	['助詞', '動詞', '助詞']
を表す	['助詞', '動詞']
は主に	['助詞', '名詞', '助詞']
の名称	['助詞', '名詞']
の元	['助詞', '名詞']
期の	['名詞', '助詞']
こととなった	['名詞', '助詞', '動詞', '助動詞']
を開始	['助詞', '名詞']
になっていた	['助詞', '動詞', '助詞', '動詞', '助動詞']
時点で	['名詞', '助詞']
に当たる	['助詞', '動詞']
の他	['助詞', '名詞']
代わりに	['名詞', '助詞']
これまで	['名詞', '助詞']
を最後に	['助詞', '名詞', '助詞']
年の第	['名詞', '助詞', '接頭詞']
ための	['名詞', '助詞']
人で	['名詞', '助詞']
も存在する	['助詞', '名詞', '動詞']
の戦いで	['助詞', '名詞', '助詞']
以降の	['名詞', '助詞']
に選ばれた	['助詞', '動詞', '動詞', '助動詞']
に貢献した	['助詞', '名詞', '動詞', '助動詞']
人と	['名詞', '助詞']
のに対し	['名詞', '助詞']
種類の	['名詞', '助詞']
他にも	['名詞', '助詞', '助詞']
と言われている	['助詞', '動詞', '動詞', '助詞', '動詞']
場合がある	['名詞', '助詞', '動詞']
のことである	['助詞', '名詞', '助動詞', '助動詞']
を用いる	['助詞', '動詞']
程度の	['名詞', '助詞']
力を	['名詞', '助詞']
日に行われた	['名詞', '助詞', '動詞', '動詞', '助動詞']
試合で	['名詞', '助詞']
全体の	['名詞', '助詞']
の一つである	['助詞', '名詞', '助動詞', '助動詞']
の多くは	['助詞', '名詞', '助詞']
を始める	['助詞', '動詞']
を使った	['助詞', '動詞', '助動詞']
の意味	['助詞', '名詞']
歳の	['名詞', '助詞']
目の	['名詞', '助詞']
地に	['名詞', '助詞']
に相当する	['助詞', '名詞', '動詞']
の仕事	['助詞', '名詞']
ということ	['助詞', '名詞']
周辺の	['名詞', '助詞']
現在でも	['名詞', '助詞', '助詞']
賞を受賞	['名詞', '助詞', '名詞']
に伴う	['助詞', '動詞']
世が	['名詞', '助詞']
家は	['名詞', '助詞']
必要がある	['名詞', '助詞', '動詞']
にいた	['助詞', '動詞', '助動詞']
的には	['名詞', '助詞', '助詞']
作品の	['名詞', '助詞']
と語っている	['助詞', '動詞', '助詞', '動詞']
年代から	['名詞', '助詞']
山の	['名詞', '助詞']
と言われる	['助詞', '動詞', '動詞']
に基づき	['助詞', '動詞']
の中には	['助詞', '名詞', '助詞', '助詞']
人間の	['名詞', '助詞']
世界の	['名詞', '助詞']
色の	['名詞', '助詞']
軍が	['名詞', '助詞']
が始まった	['助詞', '動詞', '助動詞']
同様の	['名詞', '助詞']
を設立	['助詞', '名詞']
を見て	['助詞', '動詞', '助詞']
のこと	['助詞', '名詞']
子が	['名詞', '助詞']
頃から	['名詞', '助詞']
アメリカ合衆国の	['名詞', '助詞']
それらの	['名詞', '助詞']
の乱	['助詞', '名詞']
賞を受賞した	['名詞', '助詞', '名詞', '動詞', '助動詞']
を見せ	['助詞', '動詞']
回の	['名詞', '助詞']
に出場	['助詞', '名詞']
氏は	['名詞', '助詞']
の中でも	['助詞', '名詞', '助詞', '助詞']
地方の	['名詞', '助詞']
を持っていた	['助詞', '動詞', '助詞', '動詞', '助動詞']
の対象	['助詞', '名詞']
を作り	['助詞', '動詞']
を持って	['助詞', '動詞', '助詞']
下の	['名詞', '助詞']
の死後	['助詞', '名詞']
用に	['名詞', '助詞']
は非常に	['助詞', '名詞', '助詞']
上記の	['名詞', '助詞']
の父	['助詞', '名詞']
を使う	['助詞', '動詞']
日本で	['名詞', '助詞']
駅から	['名詞', '助詞']
んでいた	['名詞', '助詞', '動詞', '助動詞']
父は	['名詞', '助詞']
一連の	['名詞', '助詞']
として知られる	['助詞', '動詞', '動詞']
があるが	['助詞', '動詞', '助詞']
に加えて	['助詞', '動詞', '助詞']
世紀に	['名詞', '助詞']
に生まれた	['助詞', '動詞', '助動詞']
に終わった	['助詞', '動詞', '助動詞']
歳の時に	['名詞', '助詞', '名詞', '助詞']
に出演	['助詞', '名詞']
に応じて	['助詞', '動詞', '助詞']
となったが	['助詞', '動詞', '助動詞', '助詞']
に参加し	['助詞', '名詞', '動詞']
を獲得した	['助詞', '名詞', '動詞', '助動詞']
に基づいて	['助詞', '動詞', '助詞']
に入社	['助詞', '名詞']
そこに	['名詞', '助詞']
一定の	['名詞', '助詞']
に入団	['助詞', '名詞']
の方が	['助詞', '名詞', '助詞']
に次ぐ	['助詞', '動詞']
を務めていた	['助詞', '動詞', '助詞', '動詞', '助動詞']
の際	['助詞', '名詞']
を利用して	['助詞', '名詞', '動詞', '助詞']
時代は	['名詞', '助詞']
の死	['助詞', '名詞']
村の	['名詞', '助詞']
日付で	['名詞', '助詞']
に加入	['助詞', '名詞']
を使用した	['助詞', '名詞', '動詞', '助動詞']
に向かって	['助詞', '動詞', '助詞']
に合わせて	['助詞', '動詞', '助詞']
時から	['名詞', '助詞']
数が	['名詞', '助詞']
に出	['助詞', '動詞']
に戻り	['助詞', '動詞']
時代には	['名詞', '助詞', '助詞']
の問題	['助詞', '名詞']
前述の	['名詞', '助詞']
が可能	['助詞', '名詞']
が異なる	['助詞', '動詞']
の上	['助詞', '名詞']
の地位	['助詞', '名詞']
らと	['名詞', '助詞']
版の	['名詞', '助詞']
直後に	['名詞', '助詞']
を描く	['助詞', '動詞']
ものもある	['名詞', '助詞', '動詞']
ているが	['助詞', '動詞', '助詞']
部に	['名詞', '助詞']
を与える	['助詞', '動詞']
の姿	['助詞', '名詞']
最後に	['名詞', '助詞']
内容は	['名詞', '助詞']
に向かう	['助詞', '動詞']
を出した	['助詞', '動詞', '助動詞']
作品は	['名詞', '助詞']
に変更された	['助詞', '名詞', '動詞', '動詞', '助動詞']
際には	['名詞', '助詞', '助詞']
と述べた	['助詞', '動詞', '助動詞']
の上に	['助詞', '名詞', '助詞']
の記録	['助詞', '名詞']
政府の	['名詞', '助詞']
があったが	['助詞', '動詞', '助動詞', '助詞']
をはじめとする	['助詞', '名詞', '助詞', '動詞']
は全て	['助詞', '名詞']
の中から	['助詞', '名詞', '助詞']
に選出された	['助詞', '名詞', '動詞', '動詞', '助動詞']
年代には	['名詞', '助詞', '助詞']
郡の	['名詞', '助詞']
線が	['名詞', '助詞']
同社の	['名詞', '助詞']
を担当	['助詞', '名詞']
に移り	['助詞', '動詞']
頃に	['名詞', '助詞']
に至った	['助詞', '動詞', '助動詞']
へ移籍	['助詞', '名詞']
の設計	['助詞', '名詞']
近くの	['名詞', '助詞']
事を	['名詞', '助詞']
体の	['名詞', '助詞']
そこから	['名詞', '助詞']
作品を	['名詞', '助詞']
もあって	['助詞', '動詞', '助詞']
を失った	['助詞', '動詞', '助動詞']
の生産	['助詞', '名詞']
先の	['名詞', '助詞']
一つの	['名詞', '助詞']
ていなかった	['助詞', '動詞', '助動詞', '助動詞']
会社の	['名詞', '助詞']
の中では	['助詞', '名詞', '助詞', '助詞']
に比べて	['助詞', '動詞', '助詞']
に戻った	['助詞', '動詞', '助動詞']
当初の	['名詞', '助詞']
活動を	['名詞', '助詞']
その後の	['名詞', '助詞']
がいた	['助詞', '動詞', '助動詞']
部は	['名詞', '助詞']
種の	['名詞', '助詞']
を認め	['助詞', '動詞']
目に	['名詞', '助詞']
地区の	['名詞', '助詞']
の一環として	['助詞', '名詞', '助詞']
を代表する	['助詞', '名詞', '動詞']
時代から	['名詞', '助詞']
イタリアの	['名詞', '助詞']
の妻	['助詞', '名詞']
に従って	['助詞', '動詞', '助詞']
明らかに	['名詞', '助詞']
と呼ばれている	['助詞', '動詞', '動詞', '助詞', '動詞']
詳細は	['名詞', '助詞']
の影響で	['助詞', '名詞', '助詞']
の違い	['助詞', '名詞']
の調査	['助詞', '名詞']
弟の	['名詞', '助詞']
を元に	['助詞', '名詞', '助詞']
自分が	['名詞', '助詞']
の原因	['助詞', '名詞']
の時代	['助詞', '名詞']
自身も	['名詞', '助詞']
私は	['名詞', '助詞']
車の	['名詞', '助詞']
に沿って	['助詞', '動詞', '助詞']
の他に	['助詞', '名詞', '助詞']
間で	['名詞', '助詞']
方向に	['名詞', '助詞']
にした	['助詞', '動詞', '助動詞']
の意	['助詞', '名詞']
の発展	['助詞', '名詞']
位となった	['名詞', '助詞', '動詞', '助動詞']
以前に	['名詞', '助詞']
ていて	['助詞', '動詞', '助詞']
の位置	['助詞', '名詞']
を結成	['助詞', '名詞']
の変化	['助詞', '名詞']
の家	['助詞', '名詞']
急速に	['名詞', '助詞']
風の	['名詞', '助詞']
自身は	['名詞', '助詞']
二つの	['名詞', '助詞']
を示した	['助詞', '動詞', '助動詞']
の一種	['助詞', '名詞']
に取り	['助詞', '動詞']
を出す	['助詞', '動詞']
の新	['助詞', '名詞']
を除き	['助詞', '動詞']
の製造	['助詞', '名詞']
の前に	['助詞', '名詞', '助詞']
に伴って	['助詞', '動詞', '助詞']
決勝で	['名詞', '助詞']
位で	['名詞', '助詞']
を与えた	['助詞', '動詞', '助動詞']
大会で	['名詞', '助詞']
の関係	['助詞', '名詞']
市内の	['名詞', '助詞']
それまでの	['名詞', '助詞', '助詞']
選手として	['名詞', '助詞']
ようと	['名詞', '助詞']
を迎え	['助詞', '動詞']
ことによって	['名詞', '助詞']
過去の	['名詞', '助詞']
を与え	['助詞', '動詞']
いくつか	['名詞', '助詞']
部分は	['名詞', '助詞']
鉄道の	['名詞', '助詞']
年までに	['名詞', '助詞', '助詞']
途中で	['名詞', '助詞']
を取る	['助詞', '動詞']
が出	['助詞', '動詞']
家に	['名詞', '助詞']
向けに	['名詞', '助詞']
者として	['名詞', '助詞']
に渡り	['助詞', '動詞']
ロシアの	['名詞', '助詞']
っていない	['助詞', '動詞', '助動詞']
を行うこと	['助詞', '動詞', '名詞']
年間の	['名詞', '助詞']
専用の	['名詞', '助詞']
状に	['名詞', '助詞']
に際して	['助詞', '動詞', '助詞']
を獲得	['助詞', '名詞']
に戻る	['助詞', '動詞']
事が	['名詞', '助詞']
の特徴	['助詞', '名詞']
を除いて	['助詞', '動詞', '助詞']
ズの	['名詞', '助詞']
を担当する	['助詞', '名詞', '動詞']
ものとして	['名詞', '助詞']
を利用した	['助詞', '名詞', '動詞', '助動詞']
軍を	['名詞', '助詞']
という意味	['助詞', '名詞']
を求め	['助詞', '動詞']
独特の	['名詞', '助詞']
自体は	['名詞', '助詞']
を利用する	['助詞', '名詞', '動詞']
に住む	['助詞', '動詞']
以外に	['名詞', '助詞']
を開始し	['助詞', '名詞', '動詞']
を含め	['助詞', '動詞']
天皇の	['名詞', '助詞']
を迎えた	['助詞', '動詞', '助動詞']
分に	['名詞', '助詞']
を挙げた	['助詞', '動詞', '助動詞']
族の	['名詞', '助詞']
ここに	['名詞', '助詞']
の舞台	['助詞', '名詞']
の販売	['助詞', '名詞']
の神	['助詞', '名詞']
朝の	['名詞', '助詞']
期に	['名詞', '助詞']
の音楽	['助詞', '名詞']
中には	['名詞', '助詞', '助詞']
現代の	['名詞', '助詞']
近年では	['名詞', '助詞', '助詞']
下で	['名詞', '助詞']
本来の	['名詞', '助詞']
を打ち	['助詞', '動詞']
と呼ばれていた	['助詞', '動詞', '動詞', '助詞', '動詞', '助動詞']
に乗り	['助詞', '動詞']
の弟	['助詞', '名詞']
下に	['名詞', '助詞']
頻繁に	['名詞', '助詞']
の二	['助詞', '名詞']
を占める	['助詞', '動詞']
に含まれる	['助詞', '動詞', '動詞']
の小	['助詞', '名詞']
軍に	['名詞', '助詞']
の女性	['助詞', '名詞']
は当初	['助詞', '名詞']
に移籍した	['助詞', '名詞', '動詞', '助動詞']
駅の	['名詞', '助詞']
の声	['助詞', '名詞']
わけではない	['名詞', '助詞', '助詞', '形容詞']
者に	['名詞', '助詞']
城の	['名詞', '助詞']
所属の	['名詞', '助詞']
試合に出場し	['名詞', '助詞', '名詞', '動詞']
になっており	['助詞', '動詞', '助詞', '動詞']
を学ぶ	['助詞', '動詞']
率は	['名詞', '助詞']
が始まり	['助詞', '動詞']
といえる	['助詞', '動詞']
たこと	['名詞', '助詞']
ができる	['助詞', '動詞']
の末	['助詞', '名詞']
事件の	['名詞', '助詞']
を機に	['助詞', '名詞', '助詞']
線と	['名詞', '助詞']
を提供する	['助詞', '名詞', '動詞']
かもしれない	['助詞', '動詞', '助動詞']
方が	['名詞', '助詞']
面で	['名詞', '助詞']
既存の	['名詞', '助詞']
性を	['名詞', '助詞']
をとる	['助詞', '動詞']
代の	['名詞', '助詞']
を続けた	['助詞', '動詞', '助動詞']
場所に	['名詞', '助詞']
に所属	['助詞', '名詞']
国内の	['名詞', '助詞']
を起こす	['助詞', '動詞']
タイプの	['名詞', '助詞']
を採用した	['助詞', '名詞', '動詞', '助動詞']
番組の	['名詞', '助詞']
はすべて	['助詞', '名詞']
翌年の	['名詞', '助詞']
何か	['名詞', '助詞']
の下に	['助詞', '名詞', '助詞']
物を	['名詞', '助詞']
会の	['名詞', '助詞']
の森	['助詞', '名詞']
の活動	['助詞', '名詞']
に入ると	['助詞', '動詞', '助詞']
に参戦	['助詞', '名詞']
の指導	['助詞', '名詞']
に勤務	['助詞', '名詞']
情報を	['名詞', '助詞']
の利用	['助詞', '名詞']
に参加する	['助詞', '名詞', '動詞']
名義で	['名詞', '助詞']
法の	['名詞', '助詞']
以外にも	['名詞', '助詞', '助詞']
で行われる	['助詞', '動詞', '動詞']
を続け	['助詞', '動詞']
を見た	['助詞', '動詞', '助動詞']
ンは	['名詞', '助詞']
近年は	['名詞', '助詞']
年までは	['名詞', '助詞', '助詞']
元の	['名詞', '助詞']
を加えた	['助詞', '動詞', '助動詞']
を決めた	['助詞', '動詞', '助動詞']
付近に	['名詞', '助詞']
を見る	['助詞', '動詞']
に存在する	['助詞', '名詞', '動詞']
に成功した	['助詞', '名詞', '動詞', '助動詞']
通常は	['名詞', '助詞']
県の	['名詞', '助詞']
の内容	['助詞', '名詞']
の前	['助詞', '名詞']
といい	['助詞', '動詞']
に対応	['助詞', '名詞']
という言葉	['助詞', '名詞']
に行く	['助詞', '動詞']
を卒業	['助詞', '名詞']
寺の	['名詞', '助詞']
を設立し	['助詞', '名詞', '動詞']
の数	['助詞', '名詞']
に渡って	['助詞', '動詞', '助詞']
ものがある	['名詞', '助詞', '動詞']
の導入	['助詞', '名詞']
代表として	['名詞', '助詞']
に指定されている	['助詞', '名詞', '動詞', '動詞', '助詞', '動詞']
に達した	['助詞', '動詞', '助動詞']
社が	['名詞', '助詞']
を図る	['助詞', '動詞']
大量の	['名詞', '助詞']
と結婚	['助詞', '名詞']
の地	['助詞', '名詞']
を務めている	['助詞', '動詞', '助詞', '動詞']
を取得	['助詞', '名詞']
ようになっている	['名詞', '助詞', '動詞', '助詞', '動詞']
に入	['助詞', '名詞']
の整備	['助詞', '名詞']
を含めた	['助詞', '動詞', '助動詞']
教会の	['名詞', '助詞']
語で	['名詞', '助詞']
は大	['助詞', '名詞']
という名称	['助詞', '名詞']
へ向かう	['助詞', '動詞']
日本に	['名詞', '助詞']
を起こし	['助詞', '動詞']
に所属する	['助詞', '名詞', '動詞']
各地で	['名詞', '助詞']
としていた	['助詞', '動詞', '助詞', '動詞', '助動詞']
を理由に	['助詞', '名詞', '助詞']
を記録し	['助詞', '名詞', '動詞']
を中心とする	['助詞', '名詞', '助詞', '動詞']
ておらず	['助詞', '動詞', '助動詞']
女性の	['名詞', '助詞']
を受けている	['助詞', '動詞', '助詞', '動詞']
と結婚した	['助詞', '名詞', '動詞', '助動詞']
のちの	['名詞', '助詞']
ようとした	['名詞', '助詞', '動詞', '助動詞']
区の	['名詞', '助詞']
つつある	['助詞', '動詞']
に属し	['助詞', '動詞']
者を	['名詞', '助詞']
の放送	['助詞', '名詞']
で知られる	['助詞', '動詞', '動詞']
と異なり	['助詞', '動詞']
のことを	['助詞', '名詞', '助詞']
に用いられる	['助詞', '動詞', '動詞']
地域で	['名詞', '助詞']
を構成する	['助詞', '名詞', '動詞']
の基礎	['助詞', '名詞']
に達し	['助詞', '動詞']
を率いて	['助詞', '動詞', '助詞']
の代表	['助詞', '名詞']
号は	['名詞', '助詞']
直前に	['名詞', '助詞']
前から	['名詞', '助詞']
の三	['助詞', '名詞']
の自由	['助詞', '名詞']
に任命された	['助詞', '名詞', '動詞', '動詞', '助動詞']
といわれている	['助詞', '動詞', '動詞', '助詞', '動詞']
の活躍	['助詞', '名詞']
に及ぶ	['助詞', '動詞']
達は	['名詞', '助詞']
を多く	['助詞', '名詞']
傘下の	['名詞', '助詞']
を形成する	['助詞', '名詞', '動詞']
機が	['名詞', '助詞']
の子孫	['助詞', '名詞']
これによって	['名詞', '助詞']
のもとで	['助詞', '名詞', '助動詞']
の増加	['助詞', '名詞']
に所属し	['助詞', '名詞', '動詞']
を掲げ	['助詞', '動詞']
に入って	['助詞', '動詞', '助詞']
息子の	['名詞', '助詞']
はこれ	['助詞', '名詞']
夏の	['名詞', '助詞']
を感じ	['助詞', '動詞']
に関わる	['助詞', '動詞']
規模の	['名詞', '助詞']
容易に	['名詞', '助詞']
ことが多く	['名詞', '助詞', '名詞']
王の	['名詞', '助詞']
ときは	['名詞', '助詞']
の最初の	['助詞', '名詞', '助詞']
ってきた	['助詞', '動詞', '助動詞']
結果として	['名詞', '助詞']
に見られる	['助詞', '動詞', '動詞']
目的で	['名詞', '助詞']
会議で	['名詞', '助詞']
過去に	['名詞', '助詞']
と改名	['助詞', '名詞']
の概念	['助詞', '名詞']
を達成した	['助詞', '名詞', '動詞', '助動詞']
に立ち	['助詞', '動詞']
を求めた	['助詞', '動詞', '助動詞']
母は	['名詞', '助詞']
権を	['名詞', '助詞']
量は	['名詞', '助詞']
意味で	['名詞', '助詞']
彼を	['名詞', '助詞']
が設けられ	['助詞', '動詞', '動詞']
を出し	['助詞', '動詞']
に出場した	['助詞', '名詞', '動詞', '助動詞']
と言い	['助詞', '動詞']
線を	['名詞', '助詞']
後には	['名詞', '助詞', '助詞']
は通常	['助詞', '名詞']
と一緒に	['助詞', '名詞', '助詞']
に必要な	['助詞', '名詞', '助動詞']
を果たし	['助詞', '動詞']
を残した	['助詞', '動詞', '助動詞']
の流れ	['助詞', '名詞']
は日本	['助詞', '名詞']
を達成	['助詞', '名詞']
を受賞	['助詞', '名詞']
に出場し	['助詞', '名詞', '動詞']
方の	['名詞', '助詞']
南部の	['名詞', '助詞']
を学び	['助詞', '動詞']
ズは	['名詞', '助詞']
場合に	['名詞', '助詞']
を破り	['助詞', '動詞']
に達する	['助詞', '動詞']
を記録	['助詞', '名詞']
藩の	['名詞', '助詞']
と言われ	['助詞', '動詞', '動詞']
駅で	['名詞', '助詞']
以外は	['名詞', '助詞']
を重ね	['助詞', '動詞']
を迎える	['助詞', '動詞']
を使い	['助詞', '動詞']
ようとする	['名詞', '助詞', '動詞']
をして	['助詞', '動詞', '助詞']
契約を結んだ	['名詞', '助詞', '動詞', '助動詞']
を進め	['助詞', '動詞']
側から	['名詞', '助詞']
をきっかけに	['助詞', '名詞', '助詞']
として活動	['助詞', '名詞']
に昇格	['助詞', '名詞']
以前から	['名詞', '助詞']
直後の	['名詞', '助詞']
氏が	['名詞', '助詞']
の際には	['助詞', '名詞', '助詞', '助詞']
相手の	['名詞', '助詞']
と言った	['助詞', '動詞', '助動詞']
ここでは	['名詞', '助詞', '助詞']
の間の	['助詞', '名詞', '助詞']
の称号	['助詞', '名詞']
の部分	['助詞', '名詞']
ものに	['名詞', '助詞']
一緒に	['名詞', '助詞']
にわたる	['助詞', '動詞']
の母	['助詞', '名詞']
企業の	['名詞', '助詞']
に代わって	['助詞', '動詞', '助詞']
の前身	['助詞', '名詞']
を発売	['助詞', '名詞']
の運営	['助詞', '名詞']
に転じ	['助詞', '動詞']
をもとに	['助詞', '名詞', '助詞']
地の	['名詞', '助詞']
を用い	['助詞', '動詞']
各地の	['名詞', '助詞']
か所	['助詞', '名詞']
を示し	['助詞', '動詞']
名で	['名詞', '助詞']
を得	['助詞', '名詞']
位に	['名詞', '助詞']
は他の	['助詞', '名詞', '助詞']
を持たない	['助詞', '動詞', '助動詞']
になること	['助詞', '動詞', '名詞']
同年の	['名詞', '助詞']
月にかけて	['名詞', '助詞']
のデザイン	['助詞', '名詞']
の生活	['助詞', '名詞']
映画の	['名詞', '助詞']
付近で	['名詞', '助詞']
を作った	['助詞', '動詞', '助動詞']
を表明した	['助詞', '名詞', '動詞', '助動詞']
手に	['名詞', '助詞']
に従い	['助詞', '動詞']
市に	['名詞', '助詞']
列車が	['名詞', '助詞']
年度の	['名詞', '助詞']
を書き	['助詞', '動詞']
の楽曲	['助詞', '名詞']
の設置	['助詞', '名詞']
てしまい	['助詞', '動詞']
が起こる	['助詞', '動詞']
を扱う	['助詞', '動詞']
の番組	['助詞', '名詞']
に向かった	['助詞', '動詞', '助動詞']
はこれを	['助詞', '名詞', '助詞']
の普及	['助詞', '名詞']
は日本の	['助詞', '名詞', '助詞']
はそれぞれ	['助詞', '名詞']
てくる	['助詞', '動詞']
に出演した	['助詞', '名詞', '動詞', '助動詞']
量の	['名詞', '助詞']
と言って	['助詞', '動詞', '助詞']
の開催	['助詞', '名詞']
の言葉	['助詞', '名詞']
の設立	['助詞', '名詞']
の両方	['助詞', '名詞']
に就任し	['助詞', '名詞', '動詞']
を設立した	['助詞', '名詞', '動詞', '助動詞']
日にかけて	['名詞', '助詞']
は不明である	['助詞', '名詞', '助動詞', '助動詞']
に比べ	['助詞', '動詞']
の主要	['助詞', '名詞']
歳から	['名詞', '助詞']
を集め	['助詞', '動詞']
と表記	['助詞', '名詞']
ことはない	['名詞', '助詞', '形容詞']
によるもの	['助詞', '名詞']
と言える	['助詞', '動詞']
主人公の	['名詞', '助詞']
に設置された	['助詞', '名詞', '動詞', '動詞', '助動詞']
手を	['名詞', '助詞']
月からは	['名詞', '助詞', '助詞']
を訪れ	['助詞', '動詞']
の動き	['助詞', '名詞']
語の	['名詞', '助詞']
と述べ	['助詞', '動詞']
を通る	['助詞', '動詞']
の監督	['助詞', '名詞']
を使用している	['助詞', '名詞', '動詞', '助詞', '動詞']
と主張した	['助詞', '名詞', '動詞', '助動詞']
ことが出来る	['名詞', '助詞', '動詞']
戦後の	['名詞', '助詞']
期間は	['名詞', '助詞']
学校の	['名詞', '助詞']
付近の	['名詞', '助詞']
めて	['名詞', '助詞']
を知る	['助詞', '動詞']
版では	['名詞', '助詞', '助詞']
兄の	['名詞', '助詞']
たちに	['名詞', '助詞']
大会では	['名詞', '助詞', '助詞']
に位置している	['助詞', '名詞', '動詞', '助詞', '動詞']
にいる	['助詞', '動詞']
隻の	['名詞', '助詞']
と呼び	['助詞', '動詞']
の制作	['助詞', '名詞']
を開始する	['助詞', '名詞', '動詞']
妻の	['名詞', '助詞']
を繰り返し	['助詞', '動詞']
段階で	['名詞', '助詞']
が生じ	['助詞', '動詞']
が必要である	['助詞', '名詞', '助動詞', '助動詞']
時期に	['名詞', '助詞']
に師事	['助詞', '名詞']
の成績	['助詞', '名詞']
年頃に	['名詞', '助詞']
の一部を	['助詞', '名詞', '助詞']
の管理	['助詞', '名詞']
家が	['名詞', '助詞']
の権利	['助詞', '名詞']
自由に	['名詞', '助詞']
アメリカで	['名詞', '助詞']
部隊は	['名詞', '助詞']
役で	['名詞', '助詞']
の選手	['助詞', '名詞']
点で	['名詞', '助詞']
周囲の	['名詞', '助詞']
が挙げられる	['助詞', '動詞', '動詞']
が生まれた	['助詞', '動詞', '助動詞']
夫の	['名詞', '助詞']
内には	['名詞', '助詞', '助詞']
王国の	['名詞', '助詞']
を獲得し	['助詞', '名詞', '動詞']
が続いた	['助詞', '動詞', '助動詞']
戦の	['名詞', '助詞']
科の	['名詞', '助詞']
の外	['助詞', '名詞']
以後は	['名詞', '助詞']
駅は	['名詞', '助詞']
線は	['名詞', '助詞']
という名前	['助詞', '名詞']
仕事を	['名詞', '助詞']
を送り	['助詞', '動詞']
の支援	['助詞', '名詞']
の歌	['助詞', '名詞']
残りの	['名詞', '助詞']
に所属していた	['助詞', '名詞', '動詞', '助詞', '動詞', '助動詞']
を呼び	['助詞', '動詞']
を発表し	['助詞', '名詞', '動詞']
を投げ	['助詞', '動詞']
の情報	['助詞', '名詞']
理由は	['名詞', '助詞']
の変更	['助詞', '名詞']
を学んだ	['助詞', '動詞', '助動詞']
島に	['名詞', '助詞']
物の	['名詞', '助詞']
面積は	['名詞', '助詞']
同士の	['名詞', '助詞']
国内で	['名詞', '助詞']
事で	['名詞', '助詞']
を搭載した	['助詞', '名詞', '動詞', '助動詞']
に続く	['助詞', '動詞']
曲の	['名詞', '助詞']
に改名	['助詞', '名詞']
うちに	['名詞', '助詞']
為に	['名詞', '助詞']
が可能である	['助詞', '名詞', '助動詞', '助動詞']
を含めて	['助詞', '動詞', '助詞']
を置く	['助詞', '動詞']
最古の	['名詞', '助詞']
を探し	['助詞', '動詞']
を挙げ	['助詞', '動詞']
を起こした	['助詞', '動詞', '助動詞']
を求めて	['助詞', '動詞', '助詞']
の状態	['助詞', '名詞']
に至るまで	['助詞', '動詞', '助詞']
日本でも	['名詞', '助詞', '助詞']
にする	['助詞', '動詞']
もいる	['助詞', '動詞']
の目	['助詞', '名詞']
例として	['名詞', '助詞']
の国	['助詞', '名詞']
社は	['名詞', '助詞']
の色	['助詞', '名詞']
は現在	['助詞', '名詞']
の孫	['助詞', '名詞']
を守る	['助詞', '動詞']
党の	['名詞', '助詞']
の向上	['助詞', '名詞']
ことができた	['名詞', '助詞', '動詞', '助動詞']
の北	['助詞', '名詞']
北部の	['名詞', '助詞']
にちなんで	['助詞', '動詞', '助詞']
何も	['名詞', '助詞']
らと共に	['名詞', '助詞']
マンは	['名詞', '助詞']
を立て	['助詞', '動詞']
を備えた	['助詞', '動詞', '助動詞']
に生まれ	['助詞', '名詞']
に敗れた	['助詞', '動詞', '助動詞']
過程で	['名詞', '助詞']
最高の	['名詞', '助詞']
大幅に	['名詞', '助詞']
の首都	['助詞', '名詞']
に敗れ	['助詞', '動詞']
道を	['名詞', '助詞']
これも	['名詞', '助詞']
を失い	['助詞', '動詞']
場所で	['名詞', '助詞']
のアルバム	['助詞', '名詞']
の勝利	['助詞', '名詞']
城を	['名詞', '助詞']
車は	['名詞', '助詞']
ていること	['助詞', '動詞', '名詞']
が盛ん	['助詞', '名詞']
性が	['名詞', '助詞']
これに対して	['名詞', '助詞']
目を	['名詞', '助詞']
趣味は	['名詞', '助詞']
をかけて	['助詞', '動詞', '助詞']
も見られる	['助詞', '動詞', '動詞']
が非常に	['助詞', '名詞', '助詞']
が用いられる	['助詞', '動詞', '動詞']
当初から	['名詞', '助詞']
にあって	['助詞', '動詞', '助詞']
力が	['名詞', '助詞']
数の	['名詞', '助詞']
の指揮	['助詞', '名詞']
を見せた	['助詞', '動詞', '助動詞']
曲を	['名詞', '助詞']
の技術	['助詞', '名詞']
が起こり	['助詞', '動詞']
を採用している	['助詞', '名詞', '動詞', '助詞', '動詞']
以来の	['名詞', '助詞']
全員が	['名詞', '助詞']
らとともに	['名詞', '助詞']
役の	['名詞', '助詞']
選挙で	['名詞', '助詞']
の攻撃	['助詞', '名詞']
を決める	['助詞', '動詞']
の評価	['助詞', '名詞']
を経由して	['助詞', '名詞', '動詞', '助詞']
郡は	['名詞', '助詞']
内では	['名詞', '助詞', '助詞']
エンジンは	['名詞', '助詞']
を加え	['助詞', '動詞']
神の	['名詞', '助詞']
の花	['助詞', '名詞']
クラスの	['名詞', '助詞']
原則として	['名詞', '助詞']
一般の	['名詞', '助詞']
人口は	['名詞', '助詞']
を有し	['助詞', '動詞']
は不明	['助詞', '名詞']
車両の	['名詞', '助詞']
号の	['名詞', '助詞']
に終わり	['助詞', '動詞']
日をもって	['名詞', '助詞', '動詞', '助詞']
を訪れた	['助詞', '動詞', '助動詞']
の人気	['助詞', '名詞']
これまでの	['名詞', '助詞', '助詞']
を抱え	['助詞', '名詞']
事から	['名詞', '助詞']
等を	['名詞', '助詞']
と対戦	['助詞', '名詞']
が始まる	['助詞', '動詞']
と改称	['助詞', '名詞']
を使用し	['助詞', '名詞', '動詞']
地域に	['名詞', '助詞']
選手が	['名詞', '助詞']
の墓	['助詞', '名詞']
初となる	['名詞', '助詞', '動詞']
に到着した	['助詞', '名詞', '動詞', '助動詞']
とされていた	['助詞', '動詞', '動詞', '助詞', '動詞', '助動詞']
子と	['名詞', '助詞']
優勝を果たした	['名詞', '助詞', '動詞', '助動詞']
の場	['助詞', '名詞']
ってくる	['助詞', '動詞']
部分が	['名詞', '助詞']
の経営	['助詞', '名詞']
が入る	['助詞', '動詞']
選手の	['名詞', '助詞']
が描かれている	['助詞', '動詞', '動詞', '助詞', '動詞']
が困難	['助詞', '名詞']
ことも多い	['名詞', '助詞', '形容詞']
が残っている	['助詞', '動詞', '助詞', '動詞']
父親は	['名詞', '助詞']
版は	['名詞', '助詞']
と契約	['助詞', '名詞']
に似た	['助詞', '動詞', '助動詞']
に移った	['助詞', '動詞', '助動詞']
方に	['名詞', '助詞']
の立場	['助詞', '名詞']
世紀から	['名詞', '助詞']
と称する	['助詞', '動詞']
が出る	['助詞', '動詞']
に帰	['助詞', '名詞']
曲が	['名詞', '助詞']
は後に	['助詞', '名詞', '助詞']
アメリカでは	['名詞', '助詞', '助詞']
を組み	['助詞', '名詞']
に転向	['助詞', '名詞']
は存在しない	['助詞', '名詞', '動詞', '助動詞']
を演じた	['助詞', '動詞', '助動詞']
に進学	['助詞', '名詞']
を発見した	['助詞', '名詞', '動詞', '助動詞']
に挑戦	['助詞', '名詞']
単独で	['名詞', '助詞']
の主	['助詞', '名詞']
形は	['名詞', '助詞']
を結成し	['助詞', '名詞', '動詞']
と結婚し	['助詞', '名詞', '動詞']
日本における	['名詞', '助詞']
の構造	['助詞', '名詞']
が起こった	['助詞', '動詞', '助動詞']
用として	['名詞', '助詞']
水を	['名詞', '助詞']
へ移籍した	['助詞', '名詞', '動詞', '助動詞']
の範囲	['助詞', '名詞']
に使われる	['助詞', '動詞', '動詞']
が出た	['助詞', '動詞', '助動詞']
の次男	['助詞', '名詞']
に転	['助詞', '名詞']
の支配	['助詞', '名詞']
を集めた	['助詞', '動詞', '助動詞']
ことによる	['名詞', '助詞']
頃には	['名詞', '助詞', '助詞']
スペインの	['名詞', '助詞']
を上げ	['助詞', '動詞']
の最終	['助詞', '名詞']
関連の	['名詞', '助詞']
代表の	['名詞', '助詞']
の代わりに	['助詞', '名詞', '助詞']
を離れ	['助詞', '動詞']
を開催	['助詞', '名詞']
に仕え	['助詞', '動詞']
神社の	['名詞', '助詞']
ソンは	['名詞', '助詞']
影響を受けた	['名詞', '助詞', '動詞', '助動詞']
を目指して	['助詞', '動詞', '助詞']
を図った	['助詞', '動詞', '助動詞']
を続ける	['助詞', '動詞']
に指定された	['助詞', '名詞', '動詞', '動詞', '助動詞']
任意の	['名詞', '助詞']
ことと	['名詞', '助詞']
を終えた	['助詞', '動詞', '助動詞']
時間が	['名詞', '助詞']
大量に	['名詞', '助詞']
台の	['名詞', '助詞']
に迎え	['助詞', '動詞']
の木	['助詞', '名詞']
を与えられ	['助詞', '動詞', '動詞']
達が	['名詞', '助詞']
の記述	['助詞', '名詞']
の土地	['助詞', '名詞']
専門は	['名詞', '助詞']
場合が多い	['名詞', '助詞', '形容詞']
部分を	['名詞', '助詞']
これに対し	['名詞', '助詞']
部分に	['名詞', '助詞']
自体が	['名詞', '助詞']
に対応する	['助詞', '名詞', '動詞']
今まで	['名詞', '助詞']
類の	['名詞', '助詞']
大型の	['名詞', '助詞']
政府が	['名詞', '助詞']
局の	['名詞', '助詞']
の要素	['助詞', '名詞']
に出る	['助詞', '動詞']
の運行	['助詞', '名詞']
建物は	['名詞', '助詞']
に引き	['助詞', '動詞']
を切り	['助詞', '動詞']
を行って	['助詞', '動詞', '助詞']
の一部が	['助詞', '名詞', '助詞']
最初は	['名詞', '助詞']
の後継	['助詞', '名詞']
人口の	['名詞', '助詞']
があるため	['助詞', '動詞', '名詞']
駅まで	['名詞', '助詞']
を使用して	['助詞', '名詞', '動詞', '助詞']
の試合	['助詞', '名詞']
の長男	['助詞', '名詞']
を一	['助詞', '名詞']
もあったが	['助詞', '動詞', '助動詞', '助詞']
町に	['名詞', '助詞']
の内	['助詞', '名詞']
世界で	['名詞', '助詞']
部が	['名詞', '助詞']
の南	['助詞', '名詞']
の養子	['助詞', '名詞']
をとった	['助詞', '動詞', '助動詞']
後述の	['名詞', '助詞']
の伝統	['助詞', '名詞']
の大半	['助詞', '名詞']
協会の	['名詞', '助詞']
と考えた	['助詞', '動詞', '助動詞']
部隊の	['名詞', '助詞']
版が	['名詞', '助詞']
の発売	['助詞', '名詞']
というもの	['助詞', '名詞']
を追い	['助詞', '動詞']
を搭載し	['助詞', '名詞', '動詞']
インドの	['名詞', '助詞']
と考える	['助詞', '動詞']
様に	['名詞', '助詞']
を挟んで	['助詞', '動詞', '助詞']
を変え	['助詞', '動詞']
作品が	['名詞', '助詞']
と比べて	['助詞', '動詞', '助詞']
の建物	['助詞', '名詞']
に復帰した	['助詞', '名詞', '動詞', '助動詞']
と語った	['助詞', '動詞', '助動詞']
の多くが	['助詞', '名詞', '助詞']
をつけ	['助詞', '名詞']
準決勝で	['名詞', '助詞']
を実施	['助詞', '名詞']
に分類される	['助詞', '名詞', '動詞', '動詞']
世と	['名詞', '助詞']
級の	['名詞', '助詞']
を基に	['助詞', '名詞', '助詞']
の都市	['助詞', '名詞']
が主流	['助詞', '名詞']
敵の	['名詞', '助詞']
年頃から	['名詞', '助詞']
に復帰	['助詞', '名詞']
に掲載された	['助詞', '名詞', '動詞', '動詞', '助動詞']
の町	['助詞', '名詞']
を押し	['助詞', '動詞']
をつける	['助詞', '動詞']
を表明	['助詞', '名詞']
戦争の	['名詞', '助詞']
の拡大	['助詞', '名詞']
主演の	['名詞', '助詞']
の方	['助詞', '名詞']
の水	['助詞', '名詞']
を制作	['助詞', '名詞']
を目指した	['助詞', '動詞', '助動詞']
界の	['名詞', '助詞']
の企画	['助詞', '名詞']
は基本的に	['助詞', '名詞', '名詞', '助詞']
を書いた	['助詞', '動詞', '助動詞']
の道	['助詞', '名詞']
の総	['助詞', '名詞']
近くに	['名詞', '助詞']
に登場した	['助詞', '名詞', '動詞', '助動詞']
の差	['助詞', '名詞']
も務めた	['助詞', '動詞', '助動詞']
として活躍	['助詞', '名詞']
星の	['名詞', '助詞']
と比較して	['助詞', '名詞', '動詞', '助詞']
機は	['名詞', '助詞']
スが	['名詞', '助詞']
にそれぞれ	['助詞', '名詞']
等に	['名詞', '助詞']
を決め	['助詞', '動詞']
を受賞した	['助詞', '名詞', '動詞', '助動詞']
も行っている	['助詞', '動詞', '助詞', '動詞']
の機能	['助詞', '名詞']
期には	['名詞', '助詞', '助詞']
以上に	['名詞', '助詞']
相手に	['名詞', '助詞']
点は	['名詞', '助詞']
が決まった	['助詞', '動詞', '助動詞']
心の	['名詞', '助詞']
トンの	['名詞', '助詞']
の規定	['助詞', '名詞']
に続いて	['助詞', '動詞', '助詞']
に立つ	['助詞', '動詞']
の発生	['助詞', '名詞']
を目的として	['助詞', '名詞', '助詞']
等が	['名詞', '助詞']
地で	['名詞', '助詞']
事業を	['名詞', '助詞']
頭の	['名詞', '助詞']
はアメリカ	['助詞', '名詞']
普通の	['名詞', '助詞']
ことができ	['名詞', '助詞', '動詞']
のもとに	['助詞', '名詞', '助詞']
を超え	['助詞', '動詞']
作品に	['名詞', '助詞']
正確に	['名詞', '助詞']
体を	['名詞', '助詞']
北は	['名詞', '助詞']
年間に	['名詞', '助詞']
を食べる	['助詞', '動詞']
彼に	['名詞', '助詞']
姿を	['名詞', '助詞']
ているため	['助詞', '動詞', '名詞']
地域では	['名詞', '助詞', '助詞']
を介して	['助詞', '動詞', '助詞']
場で	['名詞', '助詞']
が生じる	['助詞', '動詞']
関係の	['名詞', '助詞']
南は	['名詞', '助詞']
こともできる	['名詞', '助詞', '動詞']
は当時	['助詞', '名詞']
カナダの	['名詞', '助詞']
に改称	['助詞', '名詞']
時点では	['名詞', '助詞', '助詞']
ものが多い	['名詞', '助詞', '形容詞']
が認められ	['助詞', '動詞', '動詞']
を収録した	['助詞', '名詞', '動詞', '助動詞']
をそれぞれ	['助詞', '名詞']
主催の	['名詞', '助詞']
韓国の	['名詞', '助詞']
があって	['助詞', '動詞', '助詞']
の一員	['助詞', '名詞']
の設定	['助詞', '名詞']
手で	['名詞', '助詞']
を設け	['助詞', '動詞']
父親の	['名詞', '助詞']
の話	['助詞', '名詞']
公式に	['名詞', '助詞']
の拠点	['助詞', '名詞']
の可能性	['助詞', '名詞', '名詞']
に生息する	['助詞', '名詞', '動詞']
試合に出場	['名詞', '助詞', '名詞']
の運用	['助詞', '名詞']
の基本	['助詞', '名詞']
のほかに	['助詞', '名詞', '助詞']
の撮影	['助詞', '名詞']
を形成し	['助詞', '名詞', '動詞']
所で	['名詞', '助詞']
南北に	['名詞', '助詞']
の製作	['助詞', '名詞']
ロンドンの	['名詞', '助詞']
城に	['名詞', '助詞']
の種類	['助詞', '名詞']
を目指し	['助詞', '動詞']
に就任する	['助詞', '名詞', '動詞']
の実	['助詞', '名詞']
をとり	['助詞', '動詞']
をもたらした	['助詞', '動詞', '助動詞']
をもたらす	['助詞', '動詞']
市は	['名詞', '助詞']
もあるが	['助詞', '動詞', '助詞']
エンジンの	['名詞', '助詞']
ができ	['助詞', '動詞']
ってしまう	['助詞', '動詞']
としており	['助詞', '名詞']
が行われていた	['助詞', '動詞', '動詞', '助詞', '動詞', '助動詞']
になってから	['助詞', '動詞', '助詞', '助詞']
の記事	['助詞', '名詞']
作品で	['名詞', '助詞']
システムの	['名詞', '助詞']
計画は	['名詞', '助詞']
をかけ	['助詞', '動詞']
前年の	['名詞', '助詞']
どちらも	['名詞', '助詞']
はイギリス	['助詞', '名詞']
年間で	['名詞', '助詞']
として生まれた	['助詞', '動詞', '助動詞']
の保護	['助詞', '名詞']
に巻き込まれ	['助詞', '動詞', '動詞']
といわれ	['助詞', '動詞', '動詞']
私の	['名詞', '助詞']
簡単に	['名詞', '助詞']
に選ばれ	['助詞', '動詞', '動詞']
と称し	['助詞', '動詞']
父が	['名詞', '助詞']
を卒業し	['助詞', '名詞', '動詞']
謎の	['名詞', '助詞']
階に	['名詞', '助詞']
の力	['助詞', '名詞']
の初	['助詞', '名詞']
に変え	['助詞', '動詞']
に任命され	['助詞', '名詞', '動詞', '動詞']
方法で	['名詞', '助詞']
周囲に	['名詞', '助詞']
を卒業後	['助詞', '名詞', '名詞']
西は	['名詞', '助詞']
市にある	['名詞', '助詞', '動詞']
の距離	['助詞', '名詞']
の一つとして	['助詞', '名詞', '助詞']
毎に	['名詞', '助詞']
を取った	['助詞', '動詞', '助動詞']
金を	['名詞', '助詞']
に興味	['助詞', '名詞']
同名の	['名詞', '助詞']
車両は	['名詞', '助詞']
を伴う	['助詞', '動詞']
線で	['名詞', '助詞']
川と	['名詞', '助詞']
に転じた	['助詞', '動詞', '助動詞']
最後まで	['名詞', '助詞']
オフに	['名詞', '助詞']
こととなる	['名詞', '助詞', '動詞']
戦後は	['名詞', '助詞']
のとき	['助詞', '名詞']
世紀には	['名詞', '助詞', '助詞']
のあった	['助詞', '動詞', '助動詞']
を築いた	['助詞', '動詞', '助動詞']
が起きた	['助詞', '動詞', '助動詞']
と呼称	['助詞', '名詞']
を維持し	['助詞', '名詞', '動詞']
船の	['名詞', '助詞']
を深め	['助詞', '動詞']
の意見	['助詞', '名詞']
出身で	['名詞', '助詞']
に任じられた	['助詞', '動詞', '動詞', '助動詞']
直前の	['名詞', '助詞']
のファン	['助詞', '名詞']
の象徴	['助詞', '名詞']
試合に出場した	['名詞', '助詞', '名詞', '動詞', '助動詞']
に向けた	['助詞', '動詞', '助動詞']
を進める	['助詞', '動詞']
の写真	['助詞', '名詞']
に影響	['助詞', '名詞']
の前で	['助詞', '名詞', '助詞']
のタイトル	['助詞', '名詞']
近隣の	['名詞', '助詞']
を歴任	['助詞', '名詞']
形式で	['名詞', '助詞']
現在まで	['名詞', '助詞']
海軍の	['名詞', '助詞']
の計	['助詞', '名詞']
を決定した	['助詞', '名詞', '動詞', '助動詞']
こちらは	['名詞', '助詞']
時間は	['名詞', '助詞']
システムは	['名詞', '助詞']
今度は	['名詞', '助詞']
理由として	['名詞', '助詞']
を付け	['助詞', '名詞']
名称は	['名詞', '助詞']
の演奏	['助詞', '名詞']
に行った	['助詞', '動詞', '助動詞']
があること	['助詞', '動詞', '名詞']
のなかで	['助詞', '名詞', '助詞']
の裏	['助詞', '名詞']
を誇る	['助詞', '動詞']
の主要な	['助詞', '名詞', '助動詞']
と思う	['助詞', '動詞']
十分に	['名詞', '助詞']
として知られている	['助詞', '動詞', '動詞', '助詞', '動詞']
に出走	['助詞', '名詞']
は無	['助詞', '名詞']
こともあって	['名詞', '助詞', '動詞', '助詞']
のシングル	['助詞', '名詞']
同年に	['名詞', '助詞']
に乗って	['助詞', '動詞', '助詞']
を開設	['助詞', '名詞']
を下	['助詞', '名詞']
に移転	['助詞', '名詞']
機能を	['名詞', '助詞']
に残る	['助詞', '動詞']
大会の	['名詞', '助詞']
母の	['名詞', '助詞']
はいずれも	['助詞', '名詞', '助詞']
独自に	['名詞', '助詞']
馬の	['名詞', '助詞']
歳の時	['名詞', '助詞', '名詞']
を挙げる	['助詞', '動詞']
を奪われ	['助詞', '動詞', '動詞']
誰も	['名詞', '助詞']
工場で	['名詞', '助詞']
経由で	['名詞', '助詞']
理由で	['名詞', '助詞']
面に	['名詞', '助詞']
の公式	['助詞', '名詞']
以内に	['名詞', '助詞']
子を	['名詞', '助詞']
法を	['名詞', '助詞']
という設定	['助詞', '名詞']
駅と	['名詞', '助詞']
を指し	['助詞', '動詞']
問題を	['名詞', '助詞']
の弟子	['助詞', '名詞']
字は	['名詞', '助詞']
方法は	['名詞', '助詞']
を採用し	['助詞', '名詞', '動詞']
の西	['助詞', '名詞']
方は	['名詞', '助詞']
人として	['名詞', '助詞']
節の	['名詞', '助詞']
が残る	['助詞', '動詞']
女性が	['名詞', '助詞']
の中心地	['助詞', '名詞', '名詞']
長に就任	['名詞', '助詞', '名詞']
書を	['名詞', '助詞']
がおり	['助詞', '動詞']
と見られる	['助詞', '動詞', '動詞']
量が	['名詞', '助詞']
市と	['名詞', '助詞']
群の	['名詞', '助詞']
に追い	['助詞', '動詞']
を与えられた	['助詞', '動詞', '動詞', '助動詞']
春の	['名詞', '助詞']
度に	['名詞', '助詞']
自動的に	['名詞', '助詞']
の命	['助詞', '名詞']
と見なされ	['助詞', '動詞', '動詞']
で行う	['助詞', '動詞']
小型の	['名詞', '助詞']
の王	['助詞', '名詞']
はならなかった	['助詞', '動詞', '助動詞', '助動詞']
たちを	['名詞', '助詞']
の一員として	['助詞', '名詞', '助詞']
の指導者	['助詞', '名詞', '名詞']
の名で	['助詞', '名詞', '助詞']
地域は	['名詞', '助詞']
に任じられ	['助詞', '動詞', '動詞']
隊の	['名詞', '助詞']
前後の	['名詞', '助詞']
に入学	['助詞', '名詞']
クラブの	['名詞', '助詞']
を経験	['助詞', '名詞']
全国の	['名詞', '助詞']
に編入された	['助詞', '名詞', '動詞', '動詞', '助動詞']
彼女が	['名詞', '助詞']
ことなど	['名詞', '助詞']
というのは	['助詞', '名詞', '助詞']
位となり	['名詞', '助詞', '動詞']
が可能な	['助詞', '名詞', '助動詞']
を皮切りに	['助詞', '名詞', '助詞']
の意向	['助詞', '名詞']
の著作	['助詞', '名詞']
の支持	['助詞', '名詞']
の登場	['助詞', '名詞']
事前に	['名詞', '助詞']
列車は	['名詞', '助詞']
形式の	['名詞', '助詞']
子に	['名詞', '助詞']
が起き	['助詞', '動詞']
を越えて	['助詞', '動詞', '助詞']
はフランス	['助詞', '名詞']
を残す	['助詞', '動詞']
の一部は	['助詞', '名詞', '助詞']
の役割	['助詞', '名詞']
の文字	['助詞', '名詞']
基の	['名詞', '助詞']
を設置し	['助詞', '名詞', '動詞']
のモデル	['助詞', '名詞']
に戻って	['助詞', '動詞', '助詞']
ことはできない	['名詞', '助詞', '動詞', '助動詞']
を超えた	['助詞', '動詞', '助動詞']
面では	['名詞', '助詞', '助詞']
とみられる	['助詞', '動詞', '動詞']
を取得した	['助詞', '名詞', '動詞', '助動詞']
と称される	['助詞', '動詞', '動詞']
を目的とした	['助詞', '名詞', '助詞', '動詞', '助動詞']
を受けていた	['助詞', '動詞', '助詞', '動詞', '助動詞']
の中間	['助詞', '名詞']
機を	['名詞', '助詞']
国民の	['名詞', '助詞']
体は	['名詞', '助詞']
車で	['名詞', '助詞']
上は	['名詞', '助詞']
の中の	['助詞', '名詞', '助詞']
ことができなかった	['名詞', '助詞', '動詞', '助動詞', '助動詞']
として生まれる	['助詞', '動詞']
放送の	['名詞', '助詞']
の境界	['助詞', '名詞']
を広げ	['助詞', '動詞']
ことができない	['名詞', '助詞', '動詞', '助動詞']
市で	['名詞', '助詞']
今日の	['名詞', '助詞']
オリジナルの	['名詞', '助詞']
を巡って	['助詞', '動詞', '助詞']
に選出され	['助詞', '名詞', '動詞', '動詞']
本来は	['名詞', '助詞']
の友人	['助詞', '名詞']
に進む	['助詞', '動詞']
の東	['助詞', '名詞']
曲は	['名詞', '助詞']
っていたが	['助詞', '動詞', '助動詞', '助詞']
彼らが	['名詞', '助詞']
の物語	['助詞', '名詞']
をあげ	['助詞', '動詞']
ことがあった	['名詞', '助詞', '動詞', '助動詞']
の命令	['助詞', '名詞']
面の	['名詞', '助詞']
を示している	['助詞', '動詞', '助詞', '動詞']
という形で	['助詞', '名詞', '助詞']
に拠れば	['助詞', '動詞', '助詞']
に代わり	['助詞', '動詞']
に出演し	['助詞', '名詞', '動詞']
に変更した	['助詞', '名詞', '動詞', '助動詞']
作品として	['名詞', '助詞']
を意味し	['助詞', '名詞', '動詞']
死の	['名詞', '助詞']
の名は	['助詞', '名詞', '助詞']
と称した	['助詞', '動詞', '助動詞']
元は	['名詞', '助詞']
の形状	['助詞', '名詞']
翌年には	['名詞', '助詞', '助詞']
を考える	['助詞', '動詞']
の準備	['助詞', '名詞']
本人は	['名詞', '助詞']
の協力	['助詞', '名詞']
所に	['名詞', '助詞']
に直接	['助詞', '名詞']
と並んで	['助詞', '動詞', '助詞']
有数の	['名詞', '助詞']
を起用	['助詞', '名詞']
に置かれた	['助詞', '動詞', '動詞', '助動詞']
時間の	['名詞', '助詞']
も可能	['助詞', '名詞']
川を	['名詞', '助詞']
に対応した	['助詞', '名詞', '動詞', '助動詞']
次のように	['名詞', '助詞', '名詞', '助詞']
を有している	['助詞', '動詞', '助詞', '動詞']
内での	['名詞', '助詞', '助詞']
翌年に	['名詞', '助詞']
娘の	['名詞', '助詞']
ことがあり	['名詞', '助詞', '動詞']
内にある	['名詞', '助詞', '動詞']
に建設された	['助詞', '名詞', '動詞', '動詞', '助動詞']
を対象に	['助詞', '名詞', '助詞']
の割合	['助詞', '名詞']
を問わず	['助詞', '動詞', '助動詞']
上述の	['名詞', '助詞']
近郊の	['名詞', '助詞']
を実施した	['助詞', '名詞', '動詞', '助動詞']
を考え	['助詞', '動詞']
に加わった	['助詞', '動詞', '助動詞']
軍と	['名詞', '助詞']
位を獲得	['名詞', '助詞', '名詞']
部で	['名詞', '助詞']
日本での	['名詞', '助詞', '助詞']
ということで	['助詞', '名詞', '助動詞']
年末に	['名詞', '助詞']
となるが	['助詞', '動詞', '助詞']
の妹	['助詞', '名詞']
の出演	['助詞', '名詞']
の共同	['助詞', '名詞']
監督に就任	['名詞', '助詞', '名詞']
を見せる	['助詞', '動詞']
を開いた	['助詞', '動詞', '助動詞']
を伝える	['助詞', '動詞']
高校の	['名詞', '助詞']
子供の	['名詞', '助詞']
作家の	['名詞', '助詞']
所の	['名詞', '助詞']
動物の	['名詞', '助詞']
時間を	['名詞', '助詞']
と発表した	['助詞', '名詞', '動詞', '助動詞']
のひとつである	['助詞', '名詞', '助動詞', '助動詞']
の平均	['助詞', '名詞']
際の	['名詞', '助詞']
足を	['名詞', '助詞']
東は	['名詞', '助詞']
の車両	['助詞', '名詞']
戦争で	['名詞', '助詞']
に触れ	['助詞', '動詞']
学校で	['名詞', '助詞']
数を	['名詞', '助詞']
が現れる	['助詞', '動詞']
も含めて	['助詞', '動詞', '助詞']
植物の	['名詞', '助詞']
組の	['名詞', '助詞']
を導入し	['助詞', '名詞', '動詞']
の壁	['助詞', '名詞']
長は	['名詞', '助詞']
トは	['名詞', '助詞']
の顔	['助詞', '名詞']
の頃	['助詞', '名詞']
多くは	['名詞', '助詞']
属の	['名詞', '助詞']
といって	['助詞', '動詞', '助詞']
心を	['名詞', '助詞']
は何	['助詞', '名詞']
を発見し	['助詞', '名詞', '動詞']
どちらか	['名詞', '助詞']
のライブ	['助詞', '名詞']
部門で	['名詞', '助詞']
が続く	['助詞', '動詞']
に移行	['助詞', '名詞']
に就いた	['助詞', '動詞', '助動詞']
を残している	['助詞', '動詞', '助詞', '動詞']
鉄道が	['名詞', '助詞']
層の	['名詞', '助詞']
を歴任した	['助詞', '名詞', '動詞', '助動詞']
結果は	['名詞', '助詞']
を相手に	['助詞', '名詞', '助詞']
と思い	['助詞', '動詞']
と呼んだ	['助詞', '動詞', '助動詞']
役に	['名詞', '助詞']
付きの	['名詞', '助詞']
はドイツ	['助詞', '名詞']
東西に	['名詞', '助詞']
車が	['名詞', '助詞']
世代の	['名詞', '助詞']
ここから	['名詞', '助詞']
が生じた	['助詞', '動詞', '助動詞']
の学生	['助詞', '名詞']
葉は	['名詞', '助詞']
わせる	['助詞', '動詞']
各国の	['名詞', '助詞']
の分野で	['助詞', '名詞', '助詞']
を引き起こす	['助詞', '動詞']
の主張	['助詞', '名詞']
産の	['名詞', '助詞']
に編入	['助詞', '名詞']
の経験	['助詞', '名詞']
を名乗る	['助詞', '動詞']
に当たって	['助詞', '動詞', '助詞']
活動は	['名詞', '助詞']
の多く	['助詞', '名詞']
の教育	['助詞', '名詞']
という説	['助詞', '名詞']
の強化	['助詞', '名詞']
が設けられている	['助詞', '動詞', '動詞', '助詞', '動詞']
を執筆	['助詞', '名詞']
の路線	['助詞', '名詞']
の定義	['助詞', '名詞']
を出版	['助詞', '名詞']
架空の	['名詞', '助詞']
と評している	['助詞', '動詞', '助詞', '動詞']
ことができず	['名詞', '助詞', '動詞', '助動詞']
日付の	['名詞', '助詞']
者と	['名詞', '助詞']
川は	['名詞', '助詞']
施設の	['名詞', '助詞']
ことが多かった	['名詞', '助詞', '形容詞', '助動詞']
の名称は	['助詞', '名詞', '助詞']
全体で	['名詞', '助詞']
を残し	['助詞', '動詞']
をめぐる	['助詞', '動詞']
とする説	['助詞', '動詞', '名詞']
タイトルは	['名詞', '助詞']
年度から	['名詞', '助詞']
各地に	['名詞', '助詞']
を担う	['助詞', '動詞']
から離れ	['助詞', '動詞']
を認める	['助詞', '動詞']
場の	['名詞', '助詞']
橋の	['名詞', '助詞']
は完全に	['助詞', '名詞', '助詞']
を搭載する	['助詞', '名詞', '動詞']
バスの	['名詞', '助詞']
に見える	['助詞', '動詞']
を兼ね	['助詞', '動詞']
と合併し	['助詞', '名詞', '動詞']
を流れる	['助詞', '動詞']
に収め	['助詞', '動詞']
を連れて	['助詞', '動詞', '助詞']
に昇格した	['助詞', '名詞', '動詞', '助動詞']
の上で	['助詞', '名詞', '助詞']
の組み合わせ	['助詞', '名詞']
声が	['名詞', '助詞']
法は	['名詞', '助詞']
に従事した	['助詞', '名詞', '動詞', '助動詞']
をつけた	['助詞', '動詞', '助動詞']
後者は	['名詞', '助詞']
を知った	['助詞', '動詞', '助動詞']
をつけて	['助詞', '動詞', '助詞']
を越える	['助詞', '動詞']
を防ぐ	['助詞', '動詞']
さを	['名詞', '助詞']
城は	['名詞', '助詞']
の時点で	['助詞', '名詞', '助詞']
と信じ	['助詞', '動詞']
を作って	['助詞', '動詞', '助詞']
を舞台に	['助詞', '名詞', '助詞']
を巡る	['助詞', '動詞']
を聞き	['助詞', '動詞']
の著書	['助詞', '名詞']
を構え	['助詞', '名詞']
活動を開始	['名詞', '助詞', '名詞']
ことはなかった	['名詞', '助詞', '形容詞', '助動詞']
質の	['名詞', '助詞']
上から	['名詞', '助詞']
を置き	['助詞', '動詞']
に進み	['助詞', '動詞']
を失う	['助詞', '動詞']
地として	['名詞', '助詞']
に仕えた	['助詞', '動詞', '助動詞']
の最高	['助詞', '名詞']
を組んで	['助詞', '動詞', '助詞']
人も	['名詞', '助詞']
に指定され	['助詞', '名詞', '動詞', '動詞']
の要請	['助詞', '名詞']
本名は	['名詞', '助詞']
世界に	['名詞', '助詞']
の減少	['助詞', '名詞']
を獲得する	['助詞', '名詞', '動詞']
それらは	['名詞', '助詞']
特有の	['名詞', '助詞']
連続で	['名詞', '助詞']
夜の	['名詞', '助詞']
となったため	['助詞', '動詞', '助動詞', '名詞']
達の	['名詞', '助詞']
を避けるため	['助詞', '動詞', '名詞']
部隊が	['名詞', '助詞']
を掛け	['助詞', '動詞']
と主張している	['助詞', '名詞', '動詞', '助詞', '動詞']
の育成	['助詞', '名詞']
分野で	['名詞', '助詞']
音楽の	['名詞', '助詞']
生活を	['名詞', '助詞']
わけではなく	['名詞', '助詞', '助詞', '助動詞']
隊は	['名詞', '助詞']
王は	['名詞', '助詞']
の治療	['助詞', '名詞']
番組で	['名詞', '助詞']
前後に	['名詞', '助詞']
島は	['名詞', '助詞']
に用いる	['助詞', '動詞']
を追加	['助詞', '名詞']
に分かれ	['助詞', '名詞']
間は	['名詞', '助詞']
記録は	['名詞', '助詞']
制の	['名詞', '助詞']
を覚え	['助詞', '動詞']
をかけた	['助詞', '動詞', '助動詞']
に備え	['助詞', '動詞']
を取って	['助詞', '動詞', '助詞']
町は	['名詞', '助詞']
部分の	['名詞', '助詞']
に留まった	['助詞', '動詞', '助動詞']
に昇進	['助詞', '名詞']
を挙げている	['助詞', '動詞', '助詞', '動詞']
も参照	['助詞', '名詞']
らに	['名詞', '助詞']
鉄道は	['名詞', '助詞']
年代まで	['名詞', '助詞']
を買い	['助詞', '動詞']
自らが	['名詞', '助詞']
以降に	['名詞', '助詞']
一時は	['名詞', '助詞']
として活躍した	['助詞', '名詞', '動詞', '助動詞']
も含め	['助詞', '動詞']
作の	['名詞', '助詞']
ひとつの	['名詞', '助詞']
と思った	['助詞', '動詞', '助動詞']
容疑で	['名詞', '助詞']
人間が	['名詞', '助詞']
駅舎は	['名詞', '助詞']
議会は	['名詞', '助詞']
かなりの	['名詞', '助詞']
の住民	['助詞', '名詞']
レベルの	['名詞', '助詞']
の曲	['助詞', '名詞']
身に	['名詞', '助詞']
をあげた	['助詞', '動詞', '助動詞']
に見	['助詞', '動詞']
の領域	['助詞', '名詞']
とのこと	['名詞', '助詞']
幾つかの	['名詞', '助詞', '助詞']
は一切	['助詞', '名詞']
を担当し	['助詞', '名詞', '動詞']
内部に	['名詞', '助詞']
役として	['名詞', '助詞']
の管轄	['助詞', '名詞']
を上回る	['助詞', '動詞']
は困難	['助詞', '名詞']
点が	['名詞', '助詞']
列車の	['名詞', '助詞']
を建設する	['助詞', '名詞', '動詞']
に渡る	['助詞', '動詞']
位を記録	['名詞', '助詞', '名詞']
を踏まえ	['助詞', '動詞']
が続き	['助詞', '動詞']
に存在した	['助詞', '名詞', '動詞', '助動詞']
自分で	['名詞', '助詞']
の街	['助詞', '名詞']
方を	['名詞', '助詞']
目は	['名詞', '助詞']
を進めた	['助詞', '動詞', '助動詞']
夫が	['名詞', '助詞']
の提供	['助詞', '名詞']
冬の	['名詞', '助詞']
を要する	['助詞', '動詞']
を演じ	['助詞', '動詞']
に恵まれ	['助詞', '動詞']
率が	['名詞', '助詞']
に耐え	['助詞', '名詞']
に終わる	['助詞', '動詞']
の重要な	['助詞', '名詞', '助動詞']
を巻き	['助詞', '動詞']
話を	['名詞', '助詞']
に収録	['助詞', '名詞']
を失って	['助詞', '動詞', '助詞']
のほうが	['助詞', '名詞', '助詞']
を中心として	['助詞', '名詞', '助詞']
を強め	['助詞', '動詞']
に収録されている	['助詞', '名詞', '動詞', '動詞', '助詞', '動詞']
内容を	['名詞', '助詞']
現在に至る	['名詞', '助詞', '動詞']
木の	['名詞', '助詞']
パリの	['名詞', '助詞']
の学位	['助詞', '名詞']
にあたった	['助詞', '動詞', '助動詞']
を全て	['助詞', '名詞']
の最後の	['助詞', '名詞', '助詞']
に使用される	['助詞', '名詞', '動詞', '動詞']
形に	['名詞', '助詞']
近年の	['名詞', '助詞']
と考えていた	['助詞', '動詞', '助詞', '動詞', '助動詞']
月の第	['名詞', '助詞', '接頭詞']
の成立	['助詞', '名詞']
の間には	['助詞', '名詞', '助詞', '助詞']
世界中の	['名詞', '助詞']
を結び	['助詞', '動詞']
人物が	['名詞', '助詞']
の形	['助詞', '名詞']
の座	['助詞', '名詞']
米国の	['名詞', '助詞']
住民の	['名詞', '助詞']
に従事	['助詞', '名詞']
オランダの	['名詞', '助詞']
の小説	['助詞', '名詞']
同社は	['名詞', '助詞']
を目的に	['助詞', '名詞', '助詞']
の先端	['助詞', '名詞']
南に	['名詞', '助詞']
の独立	['助詞', '名詞']
に専念	['助詞', '名詞']
に向かい	['助詞', '動詞']
で生まれる	['助詞', '動詞']
を聞いた	['助詞', '動詞', '助動詞']
の出場	['助詞', '名詞']
を提供している	['助詞', '名詞', '動詞', '助詞', '動詞']
を唱え	['助詞', '動詞']
院の	['名詞', '助詞']
が得られる	['助詞', '動詞', '動詞']
に似ている	['助詞', '動詞', '助詞', '動詞']
光の	['名詞', '助詞']
に陥った	['助詞', '動詞', '助動詞']
を奪い	['助詞', '動詞']
を走る	['助詞', '動詞']
を開き	['助詞', '動詞']
社会の	['名詞', '助詞']
んでおり	['助詞', '動詞']
を制し	['助詞', '動詞']
金の	['名詞', '助詞']
問題が	['名詞', '助詞']
を担当している	['助詞', '名詞', '動詞', '助詞', '動詞']
に応じ	['助詞', '動詞']
たちと	['名詞', '助詞']
が使われる	['助詞', '動詞', '動詞']
を備え	['助詞', '動詞']
長を務めた	['名詞', '助詞', '動詞', '助動詞']
を設置する	['助詞', '名詞', '動詞']
を上げる	['助詞', '動詞']
ことはなく	['名詞', '助詞', '助動詞']
の政治	['助詞', '名詞']
番組は	['名詞', '助詞']
の旅	['助詞', '名詞']
を送る	['助詞', '動詞']
を備える	['助詞', '動詞']
を設置した	['助詞', '名詞', '動詞', '助動詞']
の危機	['助詞', '名詞']
に多く	['助詞', '名詞']
を行なった	['助詞', '動詞', '助動詞']
の字	['助詞', '名詞']
を組み合わせた	['助詞', '動詞', '助動詞']
を取り入れ	['助詞', '動詞']
を必要とし	['助詞', '名詞', '助詞', '動詞']
日の対	['名詞', '助詞', '名詞']
の下部組織	['助詞', '名詞', '名詞']
を記念して	['助詞', '名詞', '動詞', '助詞']
ことが明らか	['名詞', '助詞', '名詞']
通りの	['名詞', '助詞']
を装備し	['助詞', '名詞', '動詞']
の時に	['助詞', '名詞', '助詞']
の名前は	['助詞', '名詞', '助詞']
隣の	['名詞', '助詞']
の構成	['助詞', '名詞']
と言われた	['助詞', '動詞', '動詞', '助動詞']
を必要とする	['助詞', '名詞', '助詞', '動詞']
に貢献	['助詞', '名詞']
が必要となる	['助詞', '名詞', '助詞', '動詞']
を支援する	['助詞', '名詞', '動詞']
スと	['名詞', '助詞']
店の	['名詞', '助詞']
が設けられた	['助詞', '動詞', '動詞', '助動詞']
ドは	['名詞', '助詞']
の中央	['助詞', '名詞']
に続き	['助詞', '動詞']
最近では	['名詞', '助詞', '助詞']
大統領は	['名詞', '助詞']
全体が	['名詞', '助詞']
の兄	['助詞', '名詞']
につながる	['助詞', '動詞']
将来の	['名詞', '助詞']
と呼ばれるようになった	['助詞', '動詞', '動詞', '名詞', '助詞', '動詞', '助動詞']
男が	['名詞', '助詞']
の一部として	['助詞', '名詞', '助詞']
を決定する	['助詞', '名詞', '動詞']
にとどまった	['助詞', '動詞', '助動詞']
行動を	['名詞', '助詞']
製品の	['名詞', '助詞']
例は	['名詞', '助詞']
を主張し	['助詞', '名詞', '動詞']
計画が	['名詞', '助詞']
海の	['名詞', '助詞']
の家臣	['助詞', '名詞']
に抜擢され	['助詞', '名詞', '動詞', '動詞']
が与えられ	['助詞', '動詞', '動詞']
建物の	['名詞', '助詞']
構造の	['名詞', '助詞']
を変える	['助詞', '動詞']
ていき	['助詞', '動詞']
水の	['名詞', '助詞']
の観点から	['助詞', '名詞', '助詞']
に移籍し	['助詞', '名詞', '動詞']
部門の	['名詞', '助詞']
の愛称	['助詞', '名詞']
川が	['名詞', '助詞']
路線は	['名詞', '助詞']
場所は	['名詞', '助詞']
に応じた	['助詞', '動詞', '助動詞']
を紹介する	['助詞', '名詞', '動詞']
を支持し	['助詞', '名詞', '動詞']
特技は	['名詞', '助詞']
両者の	['名詞', '助詞']
に従軍	['助詞', '名詞']
に基づいた	['助詞', '動詞', '助動詞']
大統領の	['名詞', '助詞']
共通の	['名詞', '助詞']
これまでに	['名詞', '助詞', '助詞']
の聖	['助詞', '名詞']
の支配下	['助詞', '名詞', '名詞']
以降も	['名詞', '助詞']
に留まり	['助詞', '動詞']
の主題歌	['助詞', '名詞']
に分布する	['助詞', '名詞', '動詞']
を採用する	['助詞', '名詞', '動詞']
を支持する	['助詞', '名詞', '動詞']
を手に	['助詞', '名詞', '助詞']
末に	['名詞', '助詞']
の一角	['助詞', '名詞']
同期に	['名詞', '助詞']
地球の	['名詞', '助詞']
に出て	['助詞', '動詞', '助詞']
事業の	['名詞', '助詞']
は中国	['助詞', '名詞']
に隣接する	['助詞', '名詞', '動詞']
の呼称	['助詞', '名詞']
島で	['名詞', '助詞']
隊が	['名詞', '助詞']
ところに	['名詞', '助詞']
の一種である	['助詞', '名詞', '名詞', '助動詞', '助動詞']
一種の	['名詞', '助詞']
手の	['名詞', '助詞']
に接する	['助詞', '動詞']
らを	['名詞', '助詞']
の推薦	['助詞', '名詞']
通りに	['名詞', '助詞']
の女	['助詞', '名詞']
外に	['名詞', '助詞']
の三男	['助詞', '名詞']
を止め	['助詞', '名詞']
を通り	['助詞', '名詞']
を対象とした	['助詞', '名詞', '助詞', '動詞', '助動詞']
を集めて	['助詞', '動詞', '助詞']
車を	['名詞', '助詞']
多くの場合	['名詞', '助詞', '名詞']
種は	['名詞', '助詞']
に収録された	['助詞', '名詞', '動詞', '動詞', '助動詞']
を直接	['助詞', '名詞']
点を	['名詞', '助詞']
屋の	['名詞', '助詞']
必要があった	['名詞', '助詞', '動詞', '助動詞']
の詩	['助詞', '名詞']
を投じ	['助詞', '動詞']
方式の	['名詞', '助詞']
の時代に	['助詞', '名詞', '助詞']
に移転した	['助詞', '名詞', '動詞', '助動詞']
ごとの	['名詞', '助詞']
と共同で	['助詞', '名詞', '助詞']
の会	['助詞', '名詞']
の初期	['助詞', '名詞']
身の	['名詞', '助詞']
を書く	['助詞', '動詞']
明確に	['名詞', '助詞']
を多数	['助詞', '名詞']
を描き	['助詞', '動詞']
倍の	['名詞', '助詞']
石を	['名詞', '助詞']
が置かれた	['助詞', '動詞', '動詞', '助動詞']
バンドの	['名詞', '助詞']
と推定されている	['助詞', '名詞', '動詞', '動詞', '助詞', '動詞']
単位で	['名詞', '助詞']
があったため	['助詞', '動詞', '助動詞', '名詞']
を命じた	['助詞', '動詞', '助動詞']
直線で	['名詞', '助詞']
に携わる	['助詞', '動詞']
ソ連の	['名詞', '助詞']
を使用	['助詞', '名詞']
無料で	['名詞', '助詞']
例もある	['名詞', '助詞', '動詞']
日からは	['名詞', '助詞', '助詞']
を食べ	['助詞', '動詞']
組織の	['名詞', '助詞']
に着手	['助詞', '名詞']
の練習	['助詞', '名詞']
を加えて	['助詞', '動詞', '助詞']
を加える	['助詞', '動詞']
試合は	['名詞', '助詞']
の映像	['助詞', '名詞']
俳優の	['名詞', '助詞']
が図られ	['助詞', '動詞', '動詞']
会で	['名詞', '助詞']
を捨て	['助詞', '動詞']
決勝では	['名詞', '助詞', '助詞']
枠で	['名詞', '助詞']
を始めとする	['助詞', '名詞', '助詞', '動詞']
に接し	['助詞', '動詞']
村は	['名詞', '助詞']
を支える	['助詞', '動詞']
があれば	['助詞', '動詞', '助詞']
区間は	['名詞', '助詞']
体が	['名詞', '助詞']
口に	['名詞', '助詞']
の理論	['助詞', '名詞']
に就く	['助詞', '動詞']
年度に	['名詞', '助詞']
つつあった	['助詞', '動詞', '助動詞']
の始まり	['助詞', '名詞']
職を	['名詞', '助詞']
てくれた	['助詞', '動詞', '助動詞']
夫は	['名詞', '助詞']
を読み	['助詞', '動詞']
の半分	['助詞', '名詞']
の模様	['助詞', '名詞']
の報告	['助詞', '名詞']
内部の	['名詞', '助詞']
の終わり	['助詞', '動詞']
を退社	['助詞', '名詞']
のうちに	['助詞', '名詞', '助詞']
をかける	['助詞', '動詞']
に来た	['助詞', '動詞', '助動詞']
を認めた	['助詞', '動詞', '助動詞']
以外では	['名詞', '助詞', '助詞']
クは	['名詞', '助詞']
船が	['名詞', '助詞']
に代表される	['助詞', '名詞', '動詞', '動詞']
に過ぎない	['助詞', '動詞', '助動詞']
試合を	['名詞', '助詞']
を浴び	['助詞', '動詞']
跡地に	['名詞', '助詞']
と出会い	['助詞', '動詞']
を受章	['助詞', '名詞']
中央に	['名詞', '助詞']
順調に	['名詞', '助詞']
大学を卒業	['名詞', '助詞', '名詞']
が進められ	['助詞', '動詞', '動詞']
の初代	['助詞', '名詞']
に反対する	['助詞', '名詞', '動詞']
を刊行	['助詞', '名詞']
状況を	['名詞', '助詞']
を任され	['助詞', '動詞', '動詞']
を提供し	['助詞', '名詞', '動詞']
会社が	['名詞', '助詞']
の必要性	['助詞', '名詞', '名詞']
式で	['名詞', '助詞']
の人口は	['助詞', '名詞', '助詞']
氏と	['名詞', '助詞']
成績は	['名詞', '助詞']
ところを	['名詞', '助詞']
を振り	['助詞', '動詞']
部を	['名詞', '助詞']
古代の	['名詞', '助詞']
路線の	['名詞', '助詞']
ムは	['名詞', '助詞']
物が	['名詞', '助詞']
を背景に	['助詞', '名詞', '助詞']
と主張し	['助詞', '名詞', '動詞']
テレビの	['名詞', '助詞']
現地の	['名詞', '助詞']
に所属した	['助詞', '名詞', '動詞', '助動詞']
構造は	['名詞', '助詞']
ものとなっている	['名詞', '助詞', '動詞', '助詞', '動詞']
エンジンを	['名詞', '助詞']
ことについて	['名詞', '助詞']
は多くの	['助詞', '名詞', '助詞']
を継承した	['助詞', '名詞', '動詞', '助動詞']
が進んだ	['助詞', '動詞', '助動詞']
に囲まれ	['助詞', '動詞', '動詞']
が与えられた	['助詞', '動詞', '動詞', '助動詞']
によるものである	['助詞', '名詞', '助動詞', '助動詞']
を否定し	['助詞', '名詞', '動詞']
の内部	['助詞', '名詞']
に見舞われ	['助詞', '動詞', '動詞']
年代にかけて	['名詞', '助詞']
企業が	['名詞', '助詞']
に行き	['助詞', '動詞']
ズが	['名詞', '助詞']
の北側	['助詞', '名詞']
国に	['名詞', '助詞']
も含む	['助詞', '動詞']
ことはできなかった	['名詞', '助詞', '動詞', '助動詞', '助動詞']
のメイン	['助詞', '名詞']
を受け入れ	['助詞', '名詞']
に所在する	['助詞', '名詞', '動詞']
年の間	['名詞', '助詞', '名詞']
に登場	['助詞', '名詞']
と名付けられた	['助詞', '動詞', '動詞', '助動詞']
は彼の	['助詞', '名詞', '助詞']
の成功	['助詞', '名詞']
いずれの	['名詞', '助詞']
に始まる	['助詞', '動詞']
に任命	['助詞', '名詞']
部隊を	['名詞', '助詞']
トンは	['名詞', '助詞']
傾向にある	['名詞', '助詞', '動詞']
秋に	['名詞', '助詞']
を帯び	['助詞', '動詞']
個人の	['名詞', '助詞']
を利用し	['助詞', '名詞', '動詞']
帝国の	['名詞', '助詞']
を選ぶ	['助詞', '動詞']
の為に	['助詞', '名詞', '助詞']
から成る	['助詞', '動詞']
を兼任	['助詞', '名詞']
を通過する	['助詞', '名詞', '動詞']
を購入し	['助詞', '名詞', '動詞']
につれて	['助詞', '動詞', '助詞']
方式で	['名詞', '助詞']
の大半は	['助詞', '名詞', '助詞']
事件で	['名詞', '助詞']
を行なう	['助詞', '動詞']
人から	['名詞', '助詞']
を取得し	['助詞', '名詞', '動詞']
家を	['名詞', '助詞']
イングランドの	['名詞', '助詞']
の移動	['助詞', '名詞']
傾向がある	['名詞', '助詞', '動詞']
罪で	['名詞', '助詞']
の発見	['助詞', '名詞']
対象となる	['名詞', '助詞', '動詞']
を開発した	['助詞', '名詞', '動詞', '助動詞']
の判定	['助詞', '名詞']
今日では	['名詞', '助詞', '助詞']
者もいる	['名詞', '助詞', '動詞']
の主力	['助詞', '名詞']
と称して	['助詞', '動詞', '助詞']
とされており	['助詞', '動詞', '動詞', '助詞', '動詞']
に隣接し	['助詞', '名詞', '動詞']
を破って	['助詞', '動詞', '助詞']
英語の	['名詞', '助詞']
の方針	['助詞', '名詞']
に持ち	['助詞', '動詞']
将軍の	['名詞', '助詞']
問題は	['名詞', '助詞']
ていたという	['助詞', '動詞', '助動詞', '助詞']
写真を	['名詞', '助詞']
緑の	['名詞', '助詞']
を寄せ	['助詞', '動詞']
を得ている	['助詞', '動詞', '助詞', '動詞']
スイスの	['名詞', '助詞']
男は	['名詞', '助詞']
年までの	['名詞', '助詞', '助詞']
位置に	['名詞', '助詞']
の中心部	['助詞', '名詞', '名詞']
件の	['名詞', '助詞']
に移住	['助詞', '名詞']
これには	['名詞', '助詞', '助詞']
間を	['名詞', '助詞']
を結んだ	['助詞', '動詞', '助動詞']
に建てられた	['助詞', '動詞', '動詞', '助動詞']
国家の	['名詞', '助詞']
を模した	['助詞', '名詞', '動詞', '助動詞']
の発行	['助詞', '名詞']
に成功し	['助詞', '名詞', '動詞']
川に	['名詞', '助詞']
年に設立された	['名詞', '助詞', '名詞', '動詞', '動詞', '助動詞']
能力を	['名詞', '助詞']
門の	['名詞', '助詞']
を導入した	['助詞', '名詞', '動詞', '助動詞']
ことが発表された	['名詞', '助詞', '名詞', '動詞', '動詞', '助動詞']
人目の	['名詞', '助詞']
とされるが	['助詞', '動詞', '動詞', '助詞']
首を	['名詞', '助詞']
に於いて	['助詞', '動詞', '助詞']
の規模	['助詞', '名詞']
ことが判明した	['名詞', '助詞', '名詞', '動詞', '助動詞']
妻は	['名詞', '助詞']
号を	['名詞', '助詞']
に発生した	['助詞', '名詞', '動詞', '助動詞']
と伝えられる	['助詞', '動詞', '動詞']
山に	['名詞', '助詞']
モデルは	['名詞', '助詞']
全体に	['名詞', '助詞']
にともない	['助詞', '動詞']
を送った	['助詞', '動詞', '助動詞']
を断念	['助詞', '名詞']
を実施し	['助詞', '名詞', '動詞']
の実施	['助詞', '名詞']
投票で	['名詞', '助詞']
も多数	['助詞', '名詞']
の指示	['助詞', '名詞']
西部の	['名詞', '助詞']
を積極的に	['助詞', '名詞', '名詞', '助詞']
モデルの	['名詞', '助詞']
に変化	['助詞', '名詞']
に属した	['助詞', '動詞', '助動詞']
を入れる	['助詞', '動詞']
外の	['名詞', '助詞']
契約を	['名詞', '助詞']
月に行われた	['名詞', '助詞', '動詞', '動詞', '助動詞']
に移る	['助詞', '動詞']
全体を	['名詞', '助詞']
量を	['名詞', '助詞']
に行われる	['助詞', '動詞', '動詞']
を建設し	['助詞', '名詞', '動詞']
の軍勢	['助詞', '名詞']
を開く	['助詞', '動詞']
号が	['名詞', '助詞']
を思い	['助詞', '動詞']
関係を	['名詞', '助詞']
で行われ	['助詞', '動詞', '動詞']
を担当していた	['助詞', '名詞', '動詞', '助詞', '動詞', '助動詞']
の名称で	['助詞', '名詞', '助詞']
と戦う	['助詞', '動詞']
手段として	['名詞', '助詞']
を通って	['助詞', '動詞', '助詞']
を超えて	['助詞', '動詞', '助詞']
を差し	['助詞', '動詞']
に加わり	['助詞', '動詞']
のトップ	['助詞', '名詞']
マンの	['名詞', '助詞']
家族の	['名詞', '助詞']
街の	['名詞', '助詞']
らによって	['名詞', '助詞']
を想定し	['助詞', '名詞', '動詞']
の判断	['助詞', '名詞']
デザインは	['名詞', '助詞']
が入った	['助詞', '動詞', '助動詞']
水が	['名詞', '助詞']
を教え	['助詞', '動詞']
の精神	['助詞', '名詞']
ほかに	['名詞', '助詞']
最後は	['名詞', '助詞']
の改善	['助詞', '名詞']
を拒否した	['助詞', '名詞', '動詞', '助動詞']
ズと	['名詞', '助詞']
を記録する	['助詞', '名詞', '動詞']
都市の	['名詞', '助詞']
を勝ち	['助詞', '動詞']
選挙では	['名詞', '助詞', '助詞']
を持っており	['助詞', '動詞', '助詞', '動詞']
位を記録した	['名詞', '助詞', '名詞', '動詞', '助動詞']
位と	['名詞', '助詞']
を飾る	['助詞', '動詞']
を避け	['助詞', '動詞']
に留学	['助詞', '名詞']
計画を	['名詞', '助詞']
に襲われ	['助詞', '動詞', '動詞']
に滞在し	['助詞', '名詞', '動詞']
年に日本	['名詞', '助詞', '名詞']
と考えられ	['助詞', '動詞', '動詞']
にならない	['助詞', '動詞', '助動詞']
に入門	['助詞', '名詞']
女優の	['名詞', '助詞']
てきたが	['助詞', '動詞', '助動詞', '助詞']
の起源	['助詞', '名詞']
など多くの	['助詞', '名詞', '助詞']
を試みた	['助詞', '動詞', '助動詞']
月末に	['名詞', '助詞']
兄弟の	['名詞', '助詞']
てゆく	['助詞', '動詞']
銀行の	['名詞', '助詞']
歳のときに	['名詞', '助詞', '名詞', '助詞']
表面に	['名詞', '助詞']
と違い	['助詞', '動詞']
の有無	['助詞', '名詞']
位を獲得した	['名詞', '助詞', '名詞', '動詞', '助動詞']
病院で	['名詞', '助詞']
を演じる	['助詞', '動詞']
のいずれか	['助詞', '名詞', '助詞']
英語で	['名詞', '助詞']
の採用	['助詞', '名詞']
的にも	['名詞', '助詞', '助詞']
番組として	['名詞', '助詞']
にかかる	['助詞', '動詞']
を選んだ	['助詞', '動詞', '助動詞']
に大	['助詞', '名詞']
を見つけ	['助詞', '動詞']
と推定される	['助詞', '名詞', '動詞', '動詞']
はるかに	['名詞', '助詞']
を実施する	['助詞', '名詞', '動詞']
の地名	['助詞', '名詞']
装置は	['名詞', '助詞']
ができた	['助詞', '動詞', '助動詞']
今も	['名詞', '助詞']
イギリスでは	['名詞', '助詞', '助詞']
駅が	['名詞', '助詞']
の間では	['助詞', '名詞', '助詞', '助詞']
条の	['名詞', '助詞']
を訪ね	['助詞', '動詞']
性は	['名詞', '助詞']
に関する法律	['助詞', '名詞']
を建設した	['助詞', '名詞', '動詞', '助動詞']
試合に登板し	['名詞', '助詞', '名詞', '動詞']
に使用された	['助詞', '名詞', '動詞', '動詞', '助動詞']
をしており	['助詞', '動詞', '助詞', '動詞']
例がある	['名詞', '助詞', '動詞']
に住んでいた	['助詞', '動詞', '助詞', '動詞', '助動詞']
へ進学	['助詞', '名詞']
の影響を受け	['助詞', '名詞', '助詞', '動詞']
に関連する	['助詞', '名詞', '動詞']
上部に	['名詞', '助詞']
を開発し	['助詞', '名詞', '動詞']
人の子供	['名詞', '助詞', '名詞']
拠点として	['名詞', '助詞']
内容が	['名詞', '助詞']
ことが判明	['名詞', '助詞', '名詞']
政権の	['名詞', '助詞']
を収録	['助詞', '名詞']
はずの	['名詞', '助詞']
を増やし	['助詞', '動詞']
の会員	['助詞', '名詞']
分野の	['名詞', '助詞']
一部は	['名詞', '助詞']
に出演する	['助詞', '名詞', '動詞']
施設は	['名詞', '助詞']
に組み込まれ	['助詞', '動詞', '動詞']
会社は	['名詞', '助詞']
発の	['名詞', '助詞']
すと	['名詞', '助詞']
の廃止	['助詞', '名詞']
の主な	['助詞', '名詞', '助動詞']
の葉	['助詞', '名詞']
男の	['名詞', '助詞']
の為	['助詞', '名詞']
の確保	['助詞', '名詞']
の末に	['助詞', '名詞', '助詞']
を完全に	['助詞', '名詞', '助詞']
周辺に	['名詞', '助詞']
の治世	['助詞', '名詞']
の指揮下	['助詞', '名詞', '名詞']
で学んだ	['助詞', '動詞', '助動詞']
に変更され	['助詞', '名詞', '動詞', '動詞']
音が	['名詞', '助詞']
の反乱	['助詞', '名詞']
の後任として	['助詞', '名詞', '助詞']
をやめ	['助詞', '動詞']
の目的	['助詞', '名詞']
郊外の	['名詞', '助詞']
が置かれ	['助詞', '動詞', '動詞']
表記は	['名詞', '助詞']
教会は	['名詞', '助詞']
に出た	['助詞', '動詞', '助動詞']
が開かれ	['助詞', '動詞', '動詞']
を占め	['助詞', '動詞']
を借り	['助詞', '動詞']
湖の	['名詞', '助詞']
社から	['名詞', '助詞']
を結成した	['助詞', '名詞', '動詞', '助動詞']
を廃止し	['助詞', '名詞', '動詞']
となっていたが	['助詞', '動詞', '助詞', '動詞', '助動詞', '助詞']
が知られている	['助詞', '動詞', '動詞', '助詞', '動詞']
を指導	['助詞', '名詞']
ロワ	['名詞', '助詞']
の西側	['助詞', '名詞']
の責任	['助詞', '名詞']
誰か	['名詞', '助詞']
を行っており	['助詞', '動詞', '助詞', '動詞']
の子会社	['助詞', '名詞']
を前に	['助詞', '名詞', '助詞']
攻撃を	['名詞', '助詞']
母親は	['名詞', '助詞']
をいう	['助詞', '動詞']
に出場する	['助詞', '名詞', '動詞']
の名前が	['助詞', '名詞', '助詞']
語は	['名詞', '助詞']
同一の	['名詞', '助詞']
ように見える	['名詞', '助詞', '動詞']
を繰り返す	['助詞', '動詞']
そこには	['名詞', '助詞', '助詞']
うえで	['名詞', '助詞']
に住み	['助詞', '動詞']
に輝いた	['助詞', '動詞', '助動詞']
に覆われ	['助詞', '動詞', '動詞']
号と	['名詞', '助詞']
小学校の	['名詞', '助詞']
本人の	['名詞', '助詞']
を拠点に	['助詞', '名詞', '助詞']
として参加	['助詞', '名詞']
線を有する地上駅	['名詞', '助詞', '動詞', '名詞', '名詞']
前には	['名詞', '助詞', '助詞']
を探す	['助詞', '動詞']
に反対し	['助詞', '名詞', '動詞']
に行われた	['助詞', '動詞', '動詞', '助動詞']
の低下	['助詞', '名詞']
本人が	['名詞', '助詞']
限りで	['名詞', '助詞']
を出産	['助詞', '名詞']
に進出した	['助詞', '名詞', '動詞', '助動詞']
盛んに	['名詞', '助詞']
の絵	['助詞', '名詞']
監督は	['名詞', '助詞']
派は	['名詞', '助詞']
についた	['助詞', '動詞', '助動詞']
階の	['名詞', '助詞']
に合わせ	['助詞', '動詞']
の重要性	['助詞', '名詞', '名詞']
の東側	['助詞', '名詞']
の形成	['助詞', '名詞']
の訓練	['助詞', '名詞']
父親が	['名詞', '助詞']
に関する研究	['助詞', '名詞']
試合の出場	['名詞', '助詞', '名詞']
顔を	['名詞', '助詞']
に至って	['助詞', '動詞', '助詞']
の持つ	['助詞', '動詞']
も行われた	['助詞', '動詞', '動詞', '助動詞']
場合でも	['名詞', '助詞', '助詞']
に送り	['助詞', '動詞']
の性質	['助詞', '名詞']
ようになっていた	['名詞', '助詞', '動詞', '助詞', '動詞', '助動詞']
の歌詞	['助詞', '名詞']
を楽しむ	['助詞', '動詞']
として扱われ	['助詞', '動詞', '動詞']
時まで	['名詞', '助詞']
を行うため	['助詞', '動詞', '名詞']
に従う	['助詞', '動詞']
程度で	['名詞', '助詞']
の完成	['助詞', '名詞']
になってしまう	['助詞', '動詞', '助詞', '動詞']
以下に	['名詞', '助詞']
予選で	['名詞', '助詞']
区から	['名詞', '助詞']
と並ぶ	['助詞', '動詞']
の編集	['助詞', '名詞']
が使われている	['助詞', '動詞', '動詞', '助詞', '動詞']
役で出演	['名詞', '助詞', '名詞']
が作られた	['助詞', '動詞', '動詞', '助動詞']
者も	['名詞', '助詞']
の仲間	['助詞', '名詞']
を付けた	['助詞', '動詞', '助動詞']
紙の	['名詞', '助詞']
日に発売された	['名詞', '助詞', '名詞', '動詞', '動詞', '助動詞']
を退団	['助詞', '名詞']
患者の	['名詞', '助詞']
という意味で	['助詞', '名詞', '助詞']
議会の	['名詞', '助詞']
理由から	['名詞', '助詞']
の対立	['助詞', '名詞']
試合に出場して打率	['名詞', '助詞', '名詞', '動詞', '助詞', '名詞']
を望む	['助詞', '動詞']
てきている	['助詞', '動詞', '助詞', '動詞']
を終了した	['助詞', '名詞', '動詞', '助動詞']
を所有し	['助詞', '名詞', '動詞']
最新の	['名詞', '助詞']
を考慮し	['助詞', '名詞', '動詞']
に代わる	['助詞', '動詞']
中世の	['名詞', '助詞']
東部の	['名詞', '助詞']
と評した	['助詞', '動詞', '助動詞']
色が	['名詞', '助詞']
大半が	['名詞', '助詞']
の形態	['助詞', '名詞']
ものとなった	['名詞', '助詞', '動詞', '助動詞']
の自宅	['助詞', '名詞']
役を	['名詞', '助詞']
が必要な	['助詞', '名詞', '助動詞']
劇場で	['名詞', '助詞']
が作られ	['助詞', '動詞', '動詞']
も同様の	['助詞', '名詞', '助詞']
影響を与えた	['名詞', '助詞', '動詞', '助動詞']
が起きる	['助詞', '動詞']
として使用された	['助詞', '名詞', '動詞', '動詞', '助動詞']
の維持	['助詞', '名詞']
市場で	['名詞', '助詞']
は当時の	['助詞', '名詞', '助詞']
一族の	['名詞', '助詞']
の発表	['助詞', '名詞']
を脱	['助詞', '名詞']
秋の	['名詞', '助詞']
内容の	['名詞', '助詞']
の提案	['助詞', '名詞']
に参加している	['助詞', '名詞', '動詞', '助詞', '動詞']
を引き継いだ	['助詞', '動詞', '助動詞']
となったのは	['助詞', '動詞', '助動詞', '名詞', '助詞']
まで続いた	['助詞', '動詞', '助動詞']
事は	['名詞', '助詞']
を伸ばし	['助詞', '動詞']
を破壊し	['助詞', '名詞', '動詞']
フは	['名詞', '助詞']
土地を	['名詞', '助詞']
ことなどから	['名詞', '助詞', '助詞']
を立ち上げ	['助詞', '動詞', '名詞']
生の	['名詞', '助詞']
に尽力した	['助詞', '名詞', '動詞', '助動詞']
北に	['名詞', '助詞']
を高める	['助詞', '動詞']
初期に	['名詞', '助詞']
が見られ	['助詞', '動詞', '動詞']
に立った	['助詞', '動詞', '助動詞']
に分け	['助詞', '動詞']
を有していた	['助詞', '動詞', '助詞', '動詞', '助動詞']
京都の	['名詞', '助詞']
のに対して	['名詞', '助詞']
があったこと	['助詞', '動詞', '助動詞', '名詞']
土地の	['名詞', '助詞']
を取り上げ	['助詞', '動詞']
を通過し	['助詞', '名詞', '動詞']
から始まる	['助詞', '動詞']
艦隊の	['名詞', '助詞']
勢力を	['名詞', '助詞']
となること	['助詞', '動詞', '名詞']
も増え	['助詞', '動詞']
を高め	['助詞', '名詞']
を参照のこと	['助詞', '名詞', '助詞', '名詞']
に移動	['助詞', '名詞']
を作成し	['助詞', '名詞', '動詞']
ことを示す	['名詞', '助詞', '動詞']
を倒し	['助詞', '動詞']
として知られ	['助詞', '動詞', '動詞']
に統合され	['助詞', '名詞', '動詞', '動詞']
を入れ	['助詞', '動詞']
方面から	['名詞', '助詞']
の形で	['助詞', '名詞', '助詞']
その間に	['名詞', '助詞']
を卒業した	['助詞', '名詞', '動詞', '助動詞']
に入隊	['助詞', '名詞']
家で	['名詞', '助詞']
に悩まされ	['助詞', '動詞', '動詞']
のうちの	['助詞', '名詞', '助詞']
車両が	['名詞', '助詞']
位となる	['名詞', '助詞', '動詞']
固有の	['名詞', '助詞']
を辞任	['助詞', '名詞']
の一人である	['助詞', '名詞', '名詞', '助動詞', '助動詞']
行為を	['名詞', '助詞']
は自分の	['助詞', '名詞', '助詞']
の機会	['助詞', '名詞']
ころから	['名詞', '助詞']
左右に	['名詞', '助詞']
の連載	['助詞', '名詞']
の奥	['助詞', '名詞']
異例の	['名詞', '助詞']
に流れ	['助詞', '動詞']
へ移動	['助詞', '名詞']
音を	['名詞', '助詞']
速度は	['名詞', '助詞']
時期は	['名詞', '助詞']
ことが可能	['名詞', '助詞', '名詞']
頭に	['名詞', '助詞']
を上げた	['助詞', '動詞', '助動詞']
を手がけた	['助詞', '動詞', '助動詞']
をなす	['助詞', '動詞']
の創設	['助詞', '名詞']
年に発売された	['名詞', '助詞', '名詞', '動詞', '動詞', '助動詞']
通称は	['名詞', '助詞']
のタイトルで	['助詞', '名詞', '助詞']
モデルとして	['名詞', '助詞']
として活躍し	['助詞', '名詞', '動詞']
に敗れて	['助詞', '動詞', '助詞']
を生じ	['助詞', '動詞']
を好む	['助詞', '動詞']
の合計	['助詞', '名詞']
兵を	['名詞', '助詞']
を攻め	['助詞', '動詞']
大学に進学	['名詞', '助詞', '名詞']
型は	['名詞', '助詞']
を出して	['助詞', '動詞', '助詞']
に沿った	['助詞', '動詞', '助動詞']
物は	['名詞', '助詞']
末期の	['名詞', '助詞']
に携わった	['助詞', '動詞', '助動詞']
真の	['名詞', '助詞']
の紹介	['助詞', '名詞']
を決定	['助詞', '名詞']
に入学し	['助詞', '名詞', '動詞']
それらを	['名詞', '助詞']
晩年は	['名詞', '助詞']
優勝を飾った	['名詞', '助詞', '動詞', '助動詞']
に努め	['助詞', '動詞']
の手紙	['助詞', '名詞']
を救う	['助詞', '動詞']
になってしまった	['助詞', '動詞', '助詞', '動詞', '助動詞']
話が	['名詞', '助詞']
を得意とし	['助詞', '名詞', '助詞', '動詞']
ものも	['名詞', '助詞']
上では	['名詞', '助詞', '助詞']
年に行われた	['名詞', '助詞', '動詞', '動詞', '助動詞']
を実現する	['助詞', '名詞', '動詞']
が大幅に	['助詞', '名詞', '助詞']
風に	['名詞', '助詞']
方式は	['名詞', '助詞']
路線を	['名詞', '助詞']
に相当	['助詞', '名詞']
たびに	['名詞', '助詞']
は同年	['助詞', '名詞']
を続けている	['助詞', '動詞', '助詞', '動詞']
派と	['名詞', '助詞']
現役を引退	['名詞', '助詞', '名詞']
が入り	['助詞', '動詞']
の時期	['助詞', '名詞']
に打ち	['助詞', '動詞']
を兼ねた	['助詞', '動詞', '助動詞']
を主張した	['助詞', '名詞', '動詞', '助動詞']
の発達	['助詞', '名詞']
として起用され	['助詞', '名詞', '動詞', '動詞']
候補として	['名詞', '助詞']
北の	['名詞', '助詞']
を続けていた	['助詞', '動詞', '助詞', '動詞', '助動詞']
日までに	['名詞', '助詞', '助詞']
を参考に	['助詞', '名詞', '助詞']
に分けて	['助詞', '動詞', '助詞']
をうけ	['助詞', '動詞']
の表面	['助詞', '名詞']
に進出	['助詞', '名詞']
に落ち	['助詞', '動詞']
の思想	['助詞', '名詞']
代表に選出された	['名詞', '助詞', '名詞', '動詞', '動詞', '助動詞']
月までに	['名詞', '助詞', '助詞']
を披露した	['助詞', '名詞', '動詞', '助動詞']
の政治家	['助詞', '名詞', '名詞']
が持つ	['助詞', '動詞']
自分は	['名詞', '助詞']
の意思	['助詞', '名詞']
が容易	['助詞', '名詞']
自分を	['名詞', '助詞']
地区は	['名詞', '助詞']
を残して	['助詞', '動詞', '助詞']
敗で	['名詞', '助詞']
を使用していた	['助詞', '名詞', '動詞', '助詞', '動詞', '助動詞']
と異なる	['助詞', '動詞']
を知り	['助詞', '動詞']
の資格	['助詞', '名詞']
が認められる	['助詞', '動詞', '動詞']
これを受けて	['名詞', '助詞', '動詞', '助詞']
がつく	['助詞', '動詞']
夏に	['名詞', '助詞']
を交え	['助詞', '動詞']
に設置されている	['助詞', '名詞', '動詞', '動詞', '助詞', '動詞']
名前は	['名詞', '助詞']
から発売された	['助詞', '名詞', '動詞', '動詞', '助動詞']
の表記	['助詞', '名詞']
と共演	['助詞', '名詞']
から始まった	['助詞', '動詞', '助動詞']
に押し	['助詞', '動詞']
現役を引退した	['名詞', '助詞', '名詞', '動詞', '助動詞']
町で	['名詞', '助詞']
急激に	['名詞', '助詞']
歳まで	['名詞', '助詞']
妻と	['名詞', '助詞']
半島の	['名詞', '助詞']
を抑え	['助詞', '動詞']
彼女を	['名詞', '助詞']
の供給	['助詞', '名詞']
も行われている	['助詞', '動詞', '動詞', '助詞', '動詞']
ことが知られている	['名詞', '助詞', '動詞', '動詞', '助詞', '動詞']
日本においては	['名詞', '助詞', '助詞']
当時としては	['名詞', '助詞', '助詞']
が建てられ	['助詞', '動詞', '動詞']
姿で	['名詞', '助詞']
を取り入れた	['助詞', '動詞', '助動詞']
に向け	['助詞', '動詞']
を満たす	['助詞', '動詞']
というものである	['助詞', '名詞', '助動詞', '助動詞']
という理由で	['助詞', '名詞', '助詞']
技術を	['名詞', '助詞']
旨の	['名詞', '助詞']
年の間に	['名詞', '助詞', '名詞', '助詞']
の紋章	['助詞', '名詞']
の法則	['助詞', '名詞']
と指摘している	['助詞', '名詞', '動詞', '助詞', '動詞']
も同様に	['助詞', '名詞', '助詞']
と呼んでいる	['助詞', '動詞', '助詞', '動詞']
公認で	['名詞', '助詞']
を保持し	['助詞', '名詞', '動詞']
と伝えられている	['助詞', '動詞', '動詞', '助詞', '動詞']
パリで	['名詞', '助詞']
歳のとき	['名詞', '助詞', '名詞']
を実行	['助詞', '名詞']
に限り	['助詞', '名詞']
に通う	['助詞', '動詞']
とする説もある	['助詞', '動詞', '名詞', '助詞', '動詞']
の功績	['助詞', '名詞']
の成長	['助詞', '名詞']
を手がけ	['助詞', '動詞']
沿いの	['名詞', '助詞']
を重視し	['助詞', '名詞', '動詞']
と関係	['助詞', '名詞']
の需要	['助詞', '名詞']
のあいだ	['助詞', '名詞']
をつとめた	['助詞', '動詞', '助動詞']
最初から	['名詞', '助詞']
の変	['助詞', '名詞']
これに伴い	['名詞', '助詞', '動詞']
選手権では	['名詞', '助詞', '助詞']
位に終わった	['名詞', '助詞', '動詞', '助動詞']
水域は	['名詞', '助詞']
対策として	['名詞', '助詞']
を組織し	['助詞', '名詞', '動詞']
近くで	['名詞', '助詞']
が入っている	['助詞', '動詞', '助詞', '動詞']
の地下	['助詞', '名詞']
の作成	['助詞', '名詞']
細胞の	['名詞', '助詞']
を集める	['助詞', '動詞']
を呼んだ	['助詞', '動詞', '助動詞']
を遂げ	['助詞', '動詞']
に適した	['助詞', '動詞', '助動詞']
を描いている	['助詞', '動詞', '助詞', '動詞']
を境に	['助詞', '名詞', '助詞']
に特化した	['助詞', '名詞', '名詞', '動詞', '助動詞']
と見られている	['助詞', '動詞', '動詞', '助詞', '動詞']
を提案した	['助詞', '名詞', '動詞', '助動詞']
に勝利し	['助詞', '名詞', '動詞']
多額の	['名詞', '助詞']
全てが	['名詞', '助詞']
得点を挙げ	['名詞', '助詞', '動詞']
などして	['助詞', '動詞', '助詞']
の決定	['助詞', '名詞']
の中で最も	['助詞', '名詞', '助詞', '副詞']
に編入され	['助詞', '名詞', '動詞', '動詞']
を置いた	['助詞', '動詞', '助動詞']
形が	['名詞', '助詞']
を整え	['助詞', '動詞']
に面した	['助詞', '動詞', '助動詞']
活動を続け	['名詞', '助詞', '動詞']
際は	['名詞', '助詞']
イギリスで	['名詞', '助詞']
限定で	['名詞', '助詞']
のが特徴	['名詞', '助詞', '名詞']
のひとり	['助詞', '名詞']
を形成している	['助詞', '名詞', '動詞', '助詞', '動詞']
周辺で	['名詞', '助詞']
住民は	['名詞', '助詞']
を紹介し	['助詞', '名詞', '動詞']
太陽の	['名詞', '助詞']
の南側	['助詞', '名詞']
を命じ	['助詞', '動詞']
機体は	['名詞', '助詞']
長男の	['名詞', '助詞']
に入れ	['助詞', '動詞']
を授与された	['助詞', '名詞', '動詞', '動詞', '助動詞']
と名乗る	['助詞', '動詞']
を逃した	['助詞', '動詞', '助動詞']
一般には	['名詞', '助詞', '助詞']
と対立し	['助詞', '名詞', '動詞']
今回の	['名詞', '助詞']
の判決	['助詞', '名詞']
がついた	['助詞', '動詞', '助動詞']
に通い	['助詞', '動詞']
や他の	['助詞', '名詞', '助詞']
台湾の	['名詞', '助詞']
の領土	['助詞', '名詞']
を設ける	['助詞', '動詞']
民主党の	['名詞', '助詞']
に使用する	['助詞', '名詞', '動詞']
ドラフトで	['名詞', '助詞']
に設立された	['助詞', '名詞', '動詞', '動詞', '助動詞']
の脚本	['助詞', '名詞']
に進んだ	['助詞', '動詞', '助動詞']
成績を残し	['名詞', '助詞', '動詞']
で覆われ	['助詞', '動詞', '動詞']
を施した	['助詞', '動詞', '助動詞']
距離は	['名詞', '助詞']
が求められる	['助詞', '動詞', '動詞']
サイズの	['名詞', '助詞']
事もある	['名詞', '助詞', '動詞']
の追加	['助詞', '名詞']
と出会う	['助詞', '動詞']
を終了	['助詞', '名詞']
に昇進した	['助詞', '名詞', '動詞', '助動詞']
に派遣され	['助詞', '名詞', '動詞', '動詞']
が見える	['助詞', '動詞']
施設として	['名詞', '助詞']
契約を締結	['名詞', '助詞', '名詞']
オフの	['名詞', '助詞']
を擁し	['助詞', '動詞']
の部屋	['助詞', '名詞']
在住の	['名詞', '助詞']
車として	['名詞', '助詞']
母方の	['名詞', '助詞']
部に所属	['名詞', '助詞', '名詞']
のため死去	['助詞', '名詞', '名詞']
に選出	['助詞', '名詞']
値は	['名詞', '助詞']
がみられる	['助詞', '動詞', '動詞']
船は	['名詞', '助詞']
の続編	['助詞', '名詞']
という語	['助詞', '名詞']
に応え	['助詞', '動詞']
日本の実業家	['名詞', '助詞', '名詞', '名詞']
たいという	['名詞', '助詞']
の主人公	['助詞', '名詞']
橋は	['名詞', '助詞']
が進む	['助詞', '動詞']
を擁する	['助詞', '動詞']
の翻訳	['助詞', '名詞']
前者は	['名詞', '助詞']
を研究し	['助詞', '名詞', '動詞']
社長の	['名詞', '助詞']
極端に	['名詞', '助詞']
背景には	['名詞', '助詞', '助詞']
を図り	['助詞', '動詞']
愛称は	['名詞', '助詞']
レベルで	['名詞', '助詞']
系統の	['名詞', '助詞']
族は	['名詞', '助詞']
に復帰し	['助詞', '名詞', '動詞']
自宅で	['名詞', '助詞']
開催の	['名詞', '助詞']
私が	['名詞', '助詞']
の目的は	['助詞', '名詞', '助詞']
の扱い	['助詞', '名詞']
説もある	['名詞', '助詞', '動詞']
西に	['名詞', '助詞']
に含まれ	['助詞', '動詞', '動詞']
に属している	['助詞', '動詞', '助詞', '動詞']
を占領した	['助詞', '名詞', '動詞', '助動詞']
前述の通り	['名詞', '助詞', '名詞']
に任ぜられ	['助詞', '名詞', '助詞', '動詞']
雄は	['名詞', '助詞']
開幕から	['名詞', '助詞']
の依頼	['助詞', '名詞']
をもち	['助詞', '名詞']
着に敗れた	['名詞', '助詞', '動詞', '助動詞']
を確保し	['助詞', '名詞', '動詞']
の説明	['助詞', '名詞']
が求められ	['助詞', '動詞', '動詞']
を飾った	['助詞', '動詞', '助動詞']
友人の	['名詞', '助詞']
歳の頃	['名詞', '助詞', '名詞']
に亡命	['助詞', '名詞']
を踏襲し	['助詞', '名詞', '動詞']
てくれる	['助詞', '動詞']
へ昇格	['助詞', '名詞']
が置かれている	['助詞', '動詞', '動詞', '助詞', '動詞']
に加盟し	['助詞', '名詞', '動詞']
会は	['名詞', '助詞']
原作の	['名詞', '助詞']
を強いられ	['助詞', '動詞', '動詞']
ナは	['名詞', '助詞']
性と	['名詞', '助詞']
と考えられていた	['助詞', '動詞', '動詞', '助詞', '動詞', '助動詞']
を信じ	['助詞', '動詞']
に選ばれる	['助詞', '動詞', '動詞']
を明らかにし	['助詞', '名詞', '助詞', '動詞']
の一つで	['助詞', '名詞', '助詞']
の敷地	['助詞', '名詞']
として用いられる	['助詞', '動詞', '動詞']
に売却され	['助詞', '名詞', '動詞', '動詞']
を維持する	['助詞', '名詞', '動詞']
を発行し	['助詞', '名詞', '動詞']
故郷の	['名詞', '助詞']
例としては	['名詞', '助詞', '助詞']
が新たに	['助詞', '名詞', '助詞']
に据え	['助詞', '動詞']
を建て	['助詞', '動詞']
の様子	['助詞', '名詞']
と記されている	['助詞', '動詞', '動詞', '助詞', '動詞']
を創刊	['助詞', '名詞']
の原型	['助詞', '名詞']
どこか	['名詞', '助詞']
活動を行う	['名詞', '助詞', '動詞']
っていった	['助詞', '動詞', '助動詞']
子供が	['名詞', '助詞']
双方の	['名詞', '助詞']
これについて	['名詞', '助詞']
今でも	['名詞', '助詞', '助詞']
を推進し	['助詞', '名詞', '動詞']
もこれ	['助詞', '名詞']
らがいる	['名詞', '助詞', '動詞']
中国では	['名詞', '助詞', '助詞']
日本へ	['名詞', '助詞']
の略	['助詞', '名詞']
系列の	['名詞', '助詞']
旨を	['名詞', '助詞']
を手がける	['助詞', '動詞']
を着用し	['助詞', '名詞', '動詞']
を落とし	['助詞', '動詞']
を大幅に	['助詞', '名詞', '助詞']
を襲名	['助詞', '名詞']
に移行した	['助詞', '名詞', '動詞', '助動詞']
を継いで	['助詞', '動詞', '助詞']
を変更し	['助詞', '名詞', '動詞']
に関心	['助詞', '名詞']
機として	['名詞', '助詞']
背番号は	['名詞', '助詞']
役割を果たした	['名詞', '助詞', '動詞', '助動詞']
に叙せられ	['助詞', '動詞', '動詞']
を移し	['助詞', '動詞']
後半に	['名詞', '助詞']
に分けられる	['助詞', '動詞', '動詞']
のシンボル	['助詞', '名詞']
を守り	['助詞', '動詞']
密かに	['名詞', '助詞']
選手権で	['名詞', '助詞']
を支え	['助詞', '動詞']
を遂げた	['助詞', '動詞', '助動詞']
攻撃を受け	['名詞', '助詞', '動詞']
を終え	['助詞', '動詞']
を売り	['助詞', '動詞']
を狙う	['助詞', '動詞']
の取材	['助詞', '名詞']
を載せ	['助詞', '動詞']
にほん	['助詞', '名詞']
母親の	['名詞', '助詞']
途中に	['名詞', '助詞']
に移住した	['助詞', '名詞', '動詞', '助動詞']
を契機に	['助詞', '名詞', '助詞']
の改良	['助詞', '名詞']
をしながら	['助詞', '動詞', '助詞']
を禁じ	['助詞', '動詞']
という名	['助詞', '名詞']
に該当する	['助詞', '名詞', '動詞']
部には	['名詞', '助詞', '助詞']
になるため	['助詞', '動詞', '名詞']
を構成し	['助詞', '名詞', '動詞']
に依存し	['助詞', '名詞', '動詞']
の安全	['助詞', '名詞']
に属していた	['助詞', '動詞', '助詞', '動詞', '助動詞']
とあり	['助詞', '動詞']
頃まで	['名詞', '助詞']
か否か	['助詞', '名詞', '助詞']
を逃れ	['助詞', '名詞']
を満たし	['助詞', '動詞']
も知られている	['助詞', '動詞', '動詞', '助詞', '動詞']
に使われた	['助詞', '動詞', '動詞', '助動詞']
の近くに	['助詞', '名詞', '助詞']
説がある	['名詞', '助詞', '動詞']
の要求	['助詞', '名詞']
の許可	['助詞', '名詞']
位にランクイン	['名詞', '助詞', '名詞', '名詞']
の名前を	['助詞', '名詞', '助詞']
に移し	['助詞', '動詞']
に作られた	['助詞', '動詞', '動詞', '助動詞']
の本拠地	['助詞', '名詞']
を攻撃し	['助詞', '名詞', '動詞']
各種の	['名詞', '助詞']
を退職	['助詞', '名詞']
となるため	['助詞', '動詞', '名詞']
というタイトル	['助詞', '名詞']
が相次いで	['助詞', '動詞', '助詞']
の総称	['助詞', '名詞']
を統合し	['助詞', '名詞', '動詞']
と並行して	['助詞', '名詞', '動詞', '助詞']
事業として	['名詞', '助詞']
番号は	['名詞', '助詞']
を合わせて	['助詞', '動詞', '助詞']
を攻撃した	['助詞', '名詞', '動詞', '助動詞']
が行った	['助詞', '動詞', '助動詞']
分で	['名詞', '助詞']
を継承し	['助詞', '名詞', '動詞']
年に第	['名詞', '助詞', '接頭詞']
に陥り	['助詞', '動詞']
と関連	['助詞', '名詞']
周辺は	['名詞', '助詞']
に設けられた	['助詞', '動詞', '動詞', '助動詞']
を築き	['助詞', '動詞']
で作られた	['助詞', '動詞', '動詞', '助動詞']
というのが	['助詞', '名詞', '助詞']
月までは	['名詞', '助詞', '助詞']
形となった	['名詞', '助詞', '動詞', '助動詞']
屈指の	['名詞', '助詞']
を招き	['助詞', '動詞']
を確保する	['助詞', '名詞', '動詞']
西側の	['名詞', '助詞']
に転換	['助詞', '名詞']
に加わる	['助詞', '動詞']
成功を収めた	['名詞', '助詞', '動詞', '助動詞']
あたりの	['名詞', '助詞']
を営む	['助詞', '動詞']
上にある	['名詞', '助詞', '動詞']
監督に就任した	['名詞', '助詞', '名詞', '動詞', '助動詞']
と組んで	['助詞', '動詞', '助詞']
を装備した	['助詞', '名詞', '動詞', '助動詞']
を辞め	['助詞', '動詞']
と報じられた	['助詞', '動詞', '動詞', '助動詞']
を設けた	['助詞', '動詞', '助動詞']
という概念	['助詞', '名詞']
を象徴する	['助詞', '名詞', '動詞']
と主張する	['助詞', '名詞', '動詞']
を経験した	['助詞', '名詞', '動詞', '助動詞']
確実に	['名詞', '助詞']
を披露し	['助詞', '名詞', '動詞']
に限らず	['助詞', '動詞', '助動詞']
の中核	['助詞', '名詞']
に就職	['助詞', '名詞']
の支払い	['助詞', '名詞']
年の映画	['名詞', '助詞', '名詞']
を開催した	['助詞', '名詞', '動詞', '助動詞']
に入っている	['助詞', '動詞', '助詞', '動詞']
という点	['助詞', '名詞']
を展開する	['助詞', '名詞', '動詞']
を以って	['助詞', '名詞', '助詞']
活動を行っている	['名詞', '助詞', '動詞', '助詞', '動詞']
関係にある	['名詞', '助詞', '動詞']
を助け	['助詞', '動詞']
の公開	['助詞', '名詞']
口から	['名詞', '助詞']
を抑える	['助詞', '動詞']
作者の	['名詞', '助詞']
初めに	['名詞', '助詞']
を倒す	['助詞', '動詞']
はあるが	['助詞', '動詞', '助詞']
を発揮し	['助詞', '名詞', '動詞']
頃より	['名詞', '助詞']
な性格	['助詞', '名詞']
の交換	['助詞', '名詞']
に由来し	['助詞', '名詞', '動詞']
を拒否し	['助詞', '名詞', '動詞']
後期の	['名詞', '助詞']
に分類され	['助詞', '名詞', '動詞', '動詞']
を検討し	['助詞', '名詞', '動詞']
に加入した	['助詞', '名詞', '動詞', '助動詞']
事となった	['名詞', '助詞', '動詞', '助動詞']
を前提とし	['助詞', '名詞', '助詞', '動詞']
の父親	['助詞', '名詞']
の誕生	['助詞', '名詞']
議会で	['名詞', '助詞']
の適用	['助詞', '名詞']
が広がる	['助詞', '動詞']
ています	['助詞', '動詞', '助動詞']
ブラジルの	['名詞', '助詞']
の区別	['助詞', '名詞']
を称え	['助詞', '名詞']
という説もある	['助詞', '名詞', '助詞', '動詞']
初期には	['名詞', '助詞', '助詞']
を振る	['助詞', '動詞']
を占めている	['助詞', '動詞', '助詞', '動詞']
を主張する	['助詞', '名詞', '動詞']
国は	['名詞', '助詞']
を経営し	['助詞', '名詞', '動詞']
勝を挙げ	['名詞', '助詞', '動詞']
をまとめた	['助詞', '動詞', '助動詞']
場合によっては	['名詞', '助詞', '助詞']
のことであった	['助詞', '名詞', '助動詞', '助動詞', '助動詞']
と改称された	['助詞', '名詞', '動詞', '動詞', '助動詞']
それによって	['名詞', '助詞']
影響を与える	['名詞', '助詞', '動詞']
を実施している	['助詞', '名詞', '動詞', '助詞', '動詞']
に不満	['助詞', '名詞']
に遭い	['助詞', '動詞']
に広がる	['助詞', '動詞']
こちらも	['名詞', '助詞']
者には	['名詞', '助詞', '助詞']
を展開した	['助詞', '名詞', '動詞', '助動詞']
を授け	['助詞', '動詞']
を制した	['助詞', '動詞', '助動詞']
に分かれる	['助詞', '動詞']
最近の	['名詞', '助詞']
内閣で	['名詞', '助詞']
に使う	['助詞', '動詞']
内閣の	['名詞', '助詞']
価格は	['名詞', '助詞']
のようなもの	['助詞', '名詞', '助動詞', '名詞']
を継いだ	['助詞', '動詞', '助動詞']
の執筆	['助詞', '名詞']
年の夏	['名詞', '助詞', '名詞']
に関わった	['助詞', '動詞', '助動詞']
翌日の	['名詞', '助詞']
戦前の	['名詞', '助詞']
を保つ	['助詞', '動詞']
を備えている	['助詞', '動詞', '助詞', '動詞']
も含まれる	['助詞', '動詞', '動詞']
を放つ	['助詞', '動詞']
を奪う	['助詞', '動詞']
になっても	['助詞', '動詞', '助詞', '助詞']
の要望	['助詞', '名詞']
を追う	['助詞', '動詞']
社長に就任	['名詞', '助詞', '名詞']
を発し	['助詞', '動詞']
を作成する	['助詞', '名詞', '動詞']
を継ぐ	['助詞', '動詞']
遺体は	['名詞', '助詞']
を出版した	['助詞', '名詞', '動詞', '助動詞']
少数の	['名詞', '助詞']
日に死去	['名詞', '助詞', '名詞']
を引く	['助詞', '動詞']
で学び	['助詞', '動詞']
と共通	['助詞', '名詞']
に分けられ	['助詞', '動詞', '動詞']
を用いている	['助詞', '動詞', '助詞', '動詞']
を展開	['助詞', '名詞']
両者は	['名詞', '助詞']
たいと	['名詞', '助詞']
前は	['名詞', '助詞']
大会に出場	['名詞', '助詞', '名詞']
敗と	['名詞', '助詞']
と答えた	['助詞', '動詞', '助動詞']
に囲まれた	['助詞', '動詞', '動詞', '助動詞']
大半の	['名詞', '助詞']
につく	['助詞', '動詞']
そこへ	['名詞', '助詞']
を組む	['助詞', '動詞']
てくれ	['助詞', '動詞']
を表している	['助詞', '動詞', '助詞', '動詞']
を招いた	['助詞', '動詞', '助動詞']
に比べると	['助詞', '動詞', '助詞']
試験に合格	['名詞', '助詞', '名詞']
から指名され	['助詞', '名詞', '動詞', '動詞']
最大で	['名詞', '助詞']
ランキングで	['名詞', '助詞']
契約を結び	['名詞', '助詞', '動詞']
という用語	['助詞', '名詞']
の権威	['助詞', '名詞']
の承認	['助詞', '名詞']
を活かし	['助詞', '動詞']
から構成され	['助詞', '名詞', '動詞', '動詞']
関ヶ原の戦い	['名詞', '助詞', '名詞']
の価値	['助詞', '名詞']
を指して	['助詞', '動詞', '助詞']
の遺体	['助詞', '名詞']
として勤務	['助詞', '名詞']
を渡り	['助詞', '動詞']
を訪れる	['助詞', '動詞']
をとって	['助詞', '動詞', '助詞']
を連載	['助詞', '名詞']
と称され	['助詞', '動詞', '動詞']
と合わせて	['助詞', '動詞', '助詞']
艦隊は	['名詞', '助詞']
を許し	['助詞', '動詞']
の家系	['助詞', '名詞']
を支持した	['助詞', '名詞', '動詞', '助動詞']
注意が必要である	['名詞', '助詞', '名詞', '助動詞', '助動詞']
勝手に	['名詞', '助詞']
を発表する	['助詞', '名詞', '動詞']
の専門家	['助詞', '名詞', '名詞']
に伝わる	['助詞', '動詞']
を再開した	['助詞', '名詞', '動詞', '助動詞']
外から	['名詞', '助詞']
の間は	['助詞', '名詞', '助詞']
ほかにも	['名詞', '助詞', '助詞']
を放棄し	['助詞', '名詞', '動詞']
相手を	['名詞', '助詞']
の生涯	['助詞', '名詞']
交互に	['名詞', '助詞']
に到着し	['助詞', '名詞', '動詞']
成功を収め	['名詞', '助詞', '動詞']
をすべて	['助詞', '名詞']
が用いられている	['助詞', '動詞', '動詞', '助詞', '動詞']
先述の	['名詞', '助詞']
によって異なる	['助詞', '動詞']
を連ね	['助詞', '動詞']
沖で	['名詞', '助詞']
町にある	['名詞', '助詞', '動詞']
に起きた	['助詞', '動詞', '助動詞']
を果たしている	['助詞', '動詞', '助詞', '動詞']
を防ぐため	['助詞', '動詞', '名詞']
とされているが	['助詞', '動詞', '動詞', '助詞', '動詞', '助詞']
を付ける	['助詞', '動詞']
に従事し	['助詞', '名詞', '動詞']
を考慮して	['助詞', '名詞', '動詞', '助詞']
由来の	['名詞', '助詞']
ごろに	['名詞', '助詞']
に従事する	['助詞', '名詞', '動詞']
が流れる	['助詞', '動詞']
を用いること	['助詞', '動詞', '名詞']
に至り	['助詞', '動詞']
を抱き	['助詞', '動詞']
前年に	['名詞', '助詞']
と合流し	['助詞', '名詞', '動詞']
それより	['名詞', '助詞']
を攻撃する	['助詞', '名詞', '動詞']
資金を	['名詞', '助詞']
も同様	['助詞', '名詞']
日に第	['名詞', '助詞', '接頭詞']
ことで知られる	['名詞', '助詞', '動詞', '動詞']
の故障	['助詞', '名詞']
結果となった	['名詞', '助詞', '動詞', '助動詞']
が認められた	['助詞', '動詞', '動詞', '助動詞']
事件が発生	['名詞', '助詞', '名詞']
今後の	['名詞', '助詞']
を支配し	['助詞', '名詞', '動詞']
両親は	['名詞', '助詞']
を入れた	['助詞', '動詞', '助動詞']
被害を受けた	['名詞', '助詞', '動詞', '助動詞']
両方の	['名詞', '助詞']
と称された	['助詞', '動詞', '動詞', '助動詞']
を強調し	['助詞', '名詞', '動詞']
俳優として	['名詞', '助詞']
を去った	['助詞', '動詞', '助動詞']
を破った	['助詞', '動詞', '助動詞']
を除いた	['助詞', '動詞', '助動詞']
という名の	['助詞', '名詞', '助詞']
家から	['名詞', '助詞']
に導いた	['助詞', '動詞', '助動詞']
監督を務めた	['名詞', '助詞', '動詞', '助動詞']
へ行く	['助詞', '動詞']
を過ごした	['助詞', '動詞', '助動詞']
本当の	['名詞', '助詞']
を宣言した	['助詞', '名詞', '動詞', '助動詞']
ってきて	['助詞', '動詞', '助詞']
と接する	['助詞', '動詞']
の所有	['助詞', '名詞']
住民が	['名詞', '助詞']
はあるものの	['助詞', '動詞', '助詞']
に配属され	['助詞', '名詞', '動詞', '動詞']
に進学し	['助詞', '名詞', '動詞']
の長男として	['助詞', '名詞', '助詞']
妹の	['名詞', '助詞']
に対応している	['助詞', '名詞', '動詞', '助詞', '動詞']
に移された	['助詞', '動詞', '動詞', '助動詞']
が始まると	['助詞', '動詞', '助詞']
を聞いて	['助詞', '動詞', '助詞']
歳で死去	['名詞', '助詞', '名詞']
監督として	['名詞', '助詞']
周辺には	['名詞', '助詞', '助詞']
に憧れ	['助詞', '動詞']
彼女に	['名詞', '助詞']
を増やす	['助詞', '動詞']
市内で	['名詞', '助詞']
国内では	['名詞', '助詞', '助詞']
の座を	['助詞', '名詞', '助詞']
その他に	['名詞', '助詞']
の元に	['助詞', '名詞', '助詞']
の登場人物	['助詞', '名詞', '名詞']
きっかけとなった	['名詞', '助詞', '動詞', '助動詞']
に師事し	['助詞', '名詞', '動詞']
の所領	['助詞', '名詞']
の後継者	['助詞', '名詞', '名詞']
の秘密	['助詞', '名詞']
の証言	['助詞', '名詞']
を下した	['助詞', '動詞', '助動詞']
略称は	['名詞', '助詞']
優勝に貢献した	['名詞', '助詞', '名詞', '動詞', '助動詞']
に到着	['助詞', '名詞']
が率いる	['助詞', '動詞']
を志し	['助詞', '動詞']
彼らを	['名詞', '助詞']
年春に	['名詞', '助詞']
女優として	['名詞', '助詞']
を経た	['助詞', '動詞', '助動詞']
に起用された	['助詞', '名詞', '動詞', '動詞', '助動詞']
に当たった	['助詞', '動詞', '助動詞']
という考え	['助詞', '名詞']
を要求した	['助詞', '名詞', '動詞', '助動詞']
を定め	['助詞', '動詞']
の成果	['助詞', '名詞']
に叙され	['助詞', '名詞', '動詞', '動詞']
を入れて	['助詞', '動詞', '助詞']
配下の	['名詞', '助詞']
を付けて	['助詞', '動詞', '助詞']
一家は	['名詞', '助詞']
に力を入れ	['助詞', '名詞', '助詞', '動詞']
の圧力	['助詞', '名詞']
が与えられる	['助詞', '動詞', '動詞']
の復活	['助詞', '名詞']
を中心に活動	['助詞', '名詞', '助詞', '名詞']
を発揮する	['助詞', '名詞', '動詞']
を導入する	['助詞', '名詞', '動詞']
を買収し	['助詞', '名詞', '動詞']
現行の	['名詞', '助詞']
を表現する	['助詞', '名詞', '動詞']
作品では	['名詞', '助詞', '助詞']
と推測される	['助詞', '名詞', '動詞', '動詞']
に陥る	['助詞', '動詞']
を離れた	['助詞', '動詞', '助動詞']
に成功する	['助詞', '名詞', '動詞']
下にある	['名詞', '助詞', '動詞']
賞を受賞している	['名詞', '助詞', '名詞', '動詞', '助詞', '動詞']
の末裔	['助詞', '名詞']
ということである	['助詞', '名詞', '助動詞', '助動詞']
の授業	['助詞', '名詞']
墓所は	['名詞', '助詞']
を抱く	['助詞', '動詞']
を訴え	['助詞', '動詞']
に置く	['助詞', '動詞']
以外で	['名詞', '助詞']
方向へ	['名詞', '助詞']
を提供した	['助詞', '名詞', '動詞', '助動詞']
を改め	['助詞', '動詞']
に始まり	['助詞', '動詞']
と並び	['助詞', '動詞']
即座に	['名詞', '助詞']
魚雷を	['名詞', '助詞']
当局は	['名詞', '助詞']
の頭文字	['助詞', '名詞']
と命名された	['助詞', '名詞', '動詞', '動詞', '助動詞']
に逃げ	['助詞', '動詞']
が増えた	['助詞', '動詞', '助動詞']
に当たり	['助詞', '名詞']
話題となった	['名詞', '助詞', '動詞', '助動詞']
を選択する	['助詞', '名詞', '動詞']
が知られる	['助詞', '動詞', '動詞']
が増える	['助詞', '動詞']
の距離にある	['助詞', '名詞', '助詞', '動詞']
日本において	['名詞', '助詞']
主人公は	['名詞', '助詞']
と契約した	['助詞', '名詞', '動詞', '助動詞']
の援助	['助詞', '名詞']
場面で	['名詞', '助詞']
の才能	['助詞', '名詞']
に配置され	['助詞', '名詞', '動詞', '動詞']
決勝に進出	['名詞', '助詞', '名詞']
間もない	['名詞', '助詞', '形容詞']
会長に就任	['名詞', '助詞', '名詞']
位になった	['名詞', '助詞', '動詞', '助動詞']
オスは	['名詞', '助詞']
を確認する	['助詞', '名詞', '動詞']
に現れる	['助詞', '動詞']
を促す	['助詞', '動詞']
法により	['名詞', '助詞']
を助ける	['助詞', '動詞']
影響を受け	['名詞', '助詞', '動詞']
を招く	['助詞', '動詞']
を見つける	['助詞', '動詞']
代表に選出され	['名詞', '助詞', '名詞', '動詞', '動詞']
で行われている	['助詞', '動詞', '動詞', '助詞', '動詞']
以下のように	['名詞', '助詞', '名詞', '助詞']
得点を挙げた	['名詞', '助詞', '動詞', '助動詞']
と呼ばれることもある	['助詞', '動詞', '動詞', '名詞', '助詞', '動詞']
名前の由来	['名詞', '助詞', '名詞']
投手として	['名詞', '助詞']
と考えている	['助詞', '動詞', '助詞', '動詞']
を表明し	['助詞', '名詞', '動詞']
を重視する	['助詞', '名詞', '動詞']
に制限	['助詞', '名詞']
を命じられ	['助詞', '動詞', '動詞']
の進行	['助詞', '名詞']
に近く	['助詞', '名詞']
に因んで	['助詞', '動詞', '助詞']
が生まれる	['助詞', '動詞']
の先輩	['助詞', '名詞']
に変更されている	['助詞', '名詞', '動詞', '動詞', '助詞', '動詞']
大学では	['名詞', '助詞', '助詞']
からなり	['助詞', '動詞']
に用いられた	['助詞', '動詞', '動詞', '助動詞']
に居住し	['助詞', '名詞', '動詞']
過去には	['名詞', '助詞', '助詞']
の悪化	['助詞', '名詞']
を突き	['助詞', '名詞']
一帯は	['名詞', '助詞']
を呈し	['助詞', '動詞']
を乗せ	['助詞', '動詞']
観点から	['名詞', '助詞']
に移住し	['助詞', '名詞', '動詞']
という内容	['助詞', '名詞']
時点の	['名詞', '助詞']
を殺し	['助詞', '動詞']
を展開している	['助詞', '名詞', '動詞', '助詞', '動詞']
は廃止され	['助詞', '名詞', '動詞', '動詞']
ことのできる	['名詞', '助詞', '動詞']
ごろから	['名詞', '助詞']
がかかる	['助詞', '動詞']
英語では	['名詞', '助詞', '助詞']
と思っていた	['助詞', '動詞', '助詞', '動詞', '助動詞']
を希望し	['助詞', '名詞', '動詞']
ことを決意	['名詞', '助詞', '名詞']
を減らす	['助詞', '動詞']
を使うこと	['助詞', '動詞', '名詞']
を伝え	['助詞', '動詞']
が行う	['助詞', '動詞']
と比べ	['助詞', '動詞']
事がある	['名詞', '助詞', '動詞']
が見られた	['助詞', '動詞', '動詞', '助動詞']
どちらの	['名詞', '助詞']
おかげで	['名詞', '助詞']
に飛び	['助詞', '動詞']
自体の	['名詞', '助詞']
を扱った	['助詞', '動詞', '助動詞']
へ移行	['助詞', '名詞']
に侵入し	['助詞', '名詞', '動詞']
方面へ	['名詞', '助詞']
と記している	['助詞', '動詞', '助詞', '動詞']
で見られる	['助詞', '動詞', '動詞']
てきて	['助詞', '動詞', '助詞']
を成功させ	['助詞', '名詞', '動詞', '動詞']
を記録している	['助詞', '名詞', '動詞', '助詞', '動詞']
の演技	['助詞', '名詞']
互いの	['名詞', '助詞']
が進んでいる	['助詞', '動詞', '助詞', '動詞']
に赴任	['助詞', '名詞']
に合格	['助詞', '名詞']
教授に就任	['名詞', '助詞', '名詞']
となってしまった	['助詞', '動詞', '助詞', '動詞', '助動詞']
を生み出す	['助詞', '動詞']
という話	['助詞', '名詞']
を忘れ	['助詞', '動詞']
を出て	['助詞', '動詞', '助詞']
を受けること	['助詞', '動詞', '名詞']
そのものが	['名詞', '助詞']
前述のように	['名詞', '助詞', '名詞', '助詞']
に分割され	['助詞', '名詞', '動詞', '動詞']
ことを示している	['名詞', '助詞', '動詞', '助詞', '動詞']
を祀る	['助詞', '動詞']
も行う	['助詞', '動詞']
に侵攻し	['助詞', '名詞', '動詞']
性の高い	['名詞', '助詞', '形容詞']
をとっている	['助詞', '動詞', '助詞', '動詞']
手術を受け	['名詞', '助詞', '動詞']
影響を与え	['名詞', '助詞', '動詞']
の持ち主	['助詞', '名詞']
で使われる	['助詞', '動詞', '動詞']
に起因する	['助詞', '名詞', '動詞']
を支配する	['助詞', '名詞', '動詞']
を除けば	['助詞', '動詞', '助詞']
という言葉は	['助詞', '名詞', '助詞']
に登録された	['助詞', '名詞', '動詞', '動詞', '助動詞']
を経由し	['助詞', '名詞', '動詞']
言葉を	['名詞', '助詞']
様子が	['名詞', '助詞']
を拡大し	['助詞', '名詞', '動詞']
を変更した	['助詞', '名詞', '動詞', '助動詞']
っていて	['助詞', '動詞', '助詞']
関係にあった	['名詞', '助詞', '動詞', '助動詞']
を停止し	['助詞', '名詞', '動詞']
に置き	['助詞', '動詞']
の双方	['助詞', '名詞']
場合も	['名詞', '助詞']
に招かれ	['助詞', '動詞', '動詞']
の長女	['助詞', '名詞']
という結果	['助詞', '名詞']
自分に	['名詞', '助詞']
当時から	['名詞', '助詞']
連覇を達成	['名詞', '助詞', '名詞']
を退任	['助詞', '名詞']
を狙って	['助詞', '動詞', '助詞']
の間を	['助詞', '名詞', '助詞']
を支えた	['助詞', '動詞', '助動詞']
を設立する	['助詞', '名詞', '動詞']
を強化し	['助詞', '名詞', '動詞']
に勝利した	['助詞', '名詞', '動詞', '助動詞']
の元で	['助詞', '名詞', '助詞']
へ移住	['助詞', '名詞']
に入党	['助詞', '名詞']
の武将	['助詞', '名詞']
から構成される	['助詞', '名詞', '動詞', '動詞']
に封じられ	['助詞', '動詞', '動詞']
川が流れ	['名詞', '助詞', '動詞']
のロゴ	['助詞', '名詞']
に取り組む	['助詞', '動詞']
を借りて	['助詞', '動詞', '助詞']
後方に	['名詞', '助詞']
を終えて	['助詞', '動詞', '助詞']
で破り	['助詞', '動詞']
ころに	['名詞', '助詞']
の傍ら	['助詞', '名詞']
に限定され	['助詞', '名詞', '動詞', '動詞']
を描いて	['助詞', '動詞', '助詞']
西側に	['名詞', '助詞']
から外れ	['助詞', '動詞']
ようになって	['名詞', '助詞', '動詞', '助詞']
を置いて	['助詞', '動詞', '助詞']
主人公が	['名詞', '助詞']
の支援を受け	['助詞', '名詞', '助詞', '動詞']
に引き続き	['助詞', '動詞']
を変えて	['助詞', '動詞', '助詞']
を生かした	['助詞', '動詞', '助動詞']
を減らし	['助詞', '動詞']
を聞く	['助詞', '動詞']
に努めた	['助詞', '動詞', '助動詞']
を発展させ	['助詞', '名詞', '動詞', '動詞']
に選出される	['助詞', '名詞', '動詞', '動詞']
を歌う	['助詞', '動詞']
に備えて	['助詞', '動詞', '助詞']
を担った	['助詞', '動詞', '助動詞']
の関係で	['助詞', '名詞', '助詞']
年代に入ると	['名詞', '助詞', '動詞', '助詞']
を修了	['助詞', '名詞']
北側に	['名詞', '助詞']
の前身である	['助詞', '名詞', '助動詞', '助動詞']
から見て	['助詞', '動詞', '助詞']
長に就任した	['名詞', '助詞', '名詞', '動詞', '助動詞']
と名付けた	['助詞', '動詞', '助動詞']
を題材にした	['助詞', '名詞', '助詞', '動詞', '助動詞']
側面に	['名詞', '助詞']
名の由来	['名詞', '助詞', '名詞']
も受け	['助詞', '動詞']
になるまで	['助詞', '動詞', '助詞']
と伝わる	['助詞', '動詞']
も行った	['助詞', '動詞', '助動詞']
を取り戻す	['助詞', '動詞']
を起こして	['助詞', '動詞', '助詞']
の一部である	['助詞', '名詞', '助動詞', '助動詞']
をはじめとした	['助詞', '名詞', '助詞', '動詞', '助動詞']
を訪問し	['助詞', '名詞', '動詞']
に集中し	['助詞', '名詞', '動詞']
は不明だが	['助詞', '名詞', '助動詞', '助詞']
を保有し	['助詞', '名詞', '動詞']
ことを発表した	['名詞', '助詞', '名詞', '動詞', '助動詞']
が続いている	['助詞', '動詞', '助詞', '動詞']
に帰国し	['助詞', '名詞', '動詞']
発言を	['名詞', '助詞']
を越え	['助詞', '動詞']
役を演じた	['名詞', '助詞', '動詞', '助動詞']
を控え	['助詞', '名詞']
へ向かった	['助詞', '動詞', '助動詞']
っておらず	['助詞', '動詞', '助動詞']
と提携し	['助詞', '名詞', '動詞']
必要があり	['名詞', '助詞', '動詞']
へ移転	['助詞', '名詞']
を発表している	['助詞', '名詞', '動詞', '助詞', '動詞']
が失われ	['助詞', '動詞', '動詞']
その他にも	['名詞', '助詞', '助詞']
に改称した	['助詞', '名詞', '動詞', '助動詞']
特典として	['名詞', '助詞']
を避ける	['助詞', '動詞']
に完成した	['助詞', '名詞', '動詞', '助動詞']
っていなかった	['助詞', '動詞', '助動詞', '助動詞']
に乗る	['助詞', '動詞']
に葬られた	['助詞', '動詞', '動詞', '助動詞']
年にアメリカ	['名詞', '助詞', '名詞']
彼と	['名詞', '助詞']
が訪れる	['助詞', '動詞']
を継ぎ	['助詞', '動詞']
を狙った	['助詞', '動詞', '助動詞']
に配備され	['助詞', '名詞', '動詞', '動詞']
前まで	['名詞', '助詞']
に優れ	['助詞', '動詞']
日の第	['名詞', '助詞', '接頭詞']
を歴任し	['助詞', '名詞', '動詞']
負けを喫した	['名詞', '助詞', '動詞', '助動詞']
単一の	['名詞', '助詞']
ことを意味する	['名詞', '助詞', '名詞', '動詞']
を批判し	['助詞', '名詞', '動詞']
をもうけた	['助詞', '動詞', '助動詞']
に放送された	['助詞', '名詞', '動詞', '動詞', '助動詞']
を重ねた	['助詞', '動詞', '助動詞']
を購入する	['助詞', '名詞', '動詞']
同年には	['名詞', '助詞', '助詞']
に対応するため	['助詞', '名詞', '動詞', '名詞']
を手掛けた	['助詞', '動詞', '助動詞']
は北緯	['助詞', '名詞']
を含んだ	['助詞', '動詞', '助動詞']
位に入った	['名詞', '助詞', '動詞', '助動詞']
やその他の	['助詞', '名詞', '助詞']
の甥	['助詞', '名詞']
本物の	['名詞', '助詞']
を目的とする	['助詞', '名詞', '助詞', '動詞']
稀に	['名詞', '助詞']
三つの	['名詞', '助詞']
に残った	['助詞', '動詞', '助動詞']
の一環	['助詞', '名詞']
をもたらし	['助詞', '動詞']
を行わ	['助詞', '動詞']
金メダルを獲得した	['名詞', '助詞', '名詞', '動詞', '助動詞']
を配置し	['助詞', '名詞', '動詞']
に入社し	['助詞', '名詞', '動詞']
を喫した	['助詞', '動詞', '助動詞']
事になる	['名詞', '助詞', '動詞']
が付いた	['助詞', '動詞', '助動詞']
現地で	['名詞', '助詞']
戦後に	['名詞', '助詞']
効果がある	['名詞', '助詞', '動詞']
現場で	['名詞', '助詞']
を図るため	['助詞', '動詞', '名詞']
を構築し	['助詞', '名詞', '動詞']
が集まる	['助詞', '動詞']
負けを喫し	['名詞', '助詞', '動詞']
と判断した	['助詞', '名詞', '動詞', '助動詞']
に復	['助詞', '名詞']
が変わる	['助詞', '動詞']
一つは	['名詞', '助詞']
事が多い	['名詞', '助詞', '形容詞']
と表記される	['助詞', '名詞', '動詞', '動詞']
か月間	['助詞', '名詞']
を要求する	['助詞', '名詞', '動詞']
とみなし	['助詞', '動詞']
へ入団	['助詞', '名詞']
の一人として	['助詞', '名詞', '名詞', '助詞']
を運営する	['助詞', '名詞', '動詞']
近くにある	['名詞', '助詞', '動詞']
を痛め	['助詞', '動詞']
に任命される	['助詞', '名詞', '動詞', '動詞']
を派遣して	['助詞', '名詞', '動詞', '助詞']
と判断し	['助詞', '名詞', '動詞']
段階では	['名詞', '助詞', '助詞']
を重視した	['助詞', '名詞', '動詞', '助動詞']
に合わせた	['助詞', '動詞', '助動詞']
が得られ	['助詞', '動詞', '動詞']
に渡った	['助詞', '動詞', '助動詞']
日のダイヤ改正	['名詞', '助詞', '名詞', '名詞']
翌日に	['名詞', '助詞']
全体として	['名詞', '助詞']
ていれば	['助詞', '動詞', '助詞']
ろうとする	['名詞', '助詞', '動詞']
影響を及ぼし	['名詞', '助詞', '動詞']
が可能となった	['助詞', '名詞', '助詞', '動詞', '助動詞']
に適	['助詞', '名詞']
方面への	['名詞', '助詞', '助詞']
と推測されている	['助詞', '名詞', '動詞', '動詞', '助詞', '動詞']
人が死亡	['名詞', '助詞', '名詞']
が出ている	['助詞', '動詞', '助詞', '動詞']
の異名	['助詞', '名詞']
を説明する	['助詞', '名詞', '動詞']
を計画し	['助詞', '名詞', '動詞']
年の時点で	['名詞', '助詞', '名詞', '助詞']
を合わせた	['助詞', '動詞', '助動詞']
を使用すること	['助詞', '名詞', '動詞', '名詞']
が現れた	['助詞', '動詞', '助動詞']
南側に	['名詞', '助詞']
をつくる	['助詞', '動詞']
それに伴い	['名詞', '助詞', '動詞']
へい	['助詞', '動詞']
に到着する	['助詞', '名詞', '動詞']
を形成した	['助詞', '名詞', '動詞', '助動詞']
世界中で	['名詞', '助詞']
に昇進し	['助詞', '名詞', '動詞']
を施し	['助詞', '動詞']
に接続する	['助詞', '名詞', '動詞']
の様子を	['助詞', '名詞', '助詞']
が進められた	['助詞', '動詞', '動詞', '助動詞']
ろうとした	['名詞', '助詞', '動詞', '助動詞']
誰でも	['名詞', '助詞', '助詞']
を放ち	['助詞', '動詞']
を提示し	['助詞', '名詞', '動詞']
を送って	['助詞', '動詞', '助詞']
を確立した	['助詞', '名詞', '動詞', '助動詞']
に及んだ	['助詞', '動詞', '助動詞']
から来た	['助詞', '動詞', '助動詞']
姿を消した	['名詞', '助詞', '動詞', '助動詞']
を下し	['助詞', '動詞']
旧来の	['名詞', '助詞']
の指揮官	['助詞', '名詞', '名詞']
に専念する	['助詞', '名詞', '動詞']
と比べると	['助詞', '動詞', '助詞']
も含めた	['助詞', '動詞', '助動詞']
に属す	['助詞', '動詞']
を犯し	['助詞', '動詞']
を購入した	['助詞', '名詞', '動詞', '助動詞']
として機能し	['助詞', '名詞', '動詞']
に係る	['助詞', '動詞']
で用いられる	['助詞', '動詞', '動詞']
注目を集めた	['名詞', '助詞', '動詞', '助動詞']
を支払う	['助詞', '動詞']
を喫し	['助詞', '動詞']
を産む	['助詞', '動詞']
を築いて	['助詞', '動詞', '助詞']
に分かれて	['助詞', '動詞', '助詞']
たりする	['助詞', '動詞']
の間に生まれた	['助詞', '名詞', '助詞', '動詞', '助動詞']
を生成する	['助詞', '名詞', '動詞']
を選び	['助詞', '動詞']
人の息子	['名詞', '助詞', '名詞']
下部に	['名詞', '助詞']
と考えられた	['助詞', '動詞', '動詞', '助動詞']
が続いていた	['助詞', '動詞', '助詞', '動詞', '助動詞']
を展開し	['助詞', '名詞', '動詞']
を変えた	['助詞', '動詞', '助動詞']
内部で	['名詞', '助詞']
を目指している	['助詞', '動詞', '助詞', '動詞']
が継いだ	['助詞', '動詞', '助動詞']
に繋がる	['助詞', '動詞']
と戦った	['助詞', '動詞', '助動詞']
に移って	['助詞', '動詞', '助詞']
を繰り返した	['助詞', '動詞', '助動詞']
の際は	['助詞', '名詞', '助詞']
活動を再開	['名詞', '助詞', '名詞']
現在に至るまで	['名詞', '助詞', '動詞', '助詞']
こととなり	['名詞', '助詞', '動詞']
を招いて	['助詞', '動詞', '助詞']
が用いられた	['助詞', '動詞', '動詞', '助動詞']
を出している	['助詞', '動詞', '助詞', '動詞']
を兼務	['助詞', '名詞']
名の由来は	['名詞', '助詞', '名詞', '助詞']
高校では	['名詞', '助詞', '助詞']
日に開催された	['名詞', '助詞', '名詞', '動詞', '動詞', '助動詞']
と区別	['助詞', '名詞']
に就いて	['助詞', '動詞', '助詞']
という点で	['助詞', '名詞', '助動詞']
として扱われる	['助詞', '動詞', '動詞']
を解決する	['助詞', '名詞', '動詞']
に由来している	['助詞', '名詞', '動詞', '助詞', '動詞']
に埋葬された	['助詞', '名詞', '動詞', '動詞', '助動詞']
といえば	['助詞', '動詞', '助詞']
に対抗する	['助詞', '名詞', '動詞']
を仕掛け	['助詞', '名詞']
らによる	['名詞', '助詞']
記録を更新	['名詞', '助詞', '名詞']
の長男として生まれる	['助詞', '名詞', '助詞', '動詞']
を指揮し	['助詞', '名詞', '動詞']
にさらされ	['助詞', '動詞', '動詞']
単純に	['名詞', '助詞']
を積んだ	['助詞', '動詞', '助動詞']
東側に	['名詞', '助詞']
科を卒業	['名詞', '助詞', '名詞']
を行なっている	['助詞', '動詞', '助詞', '動詞']
を結んでいる	['助詞', '動詞', '助詞', '動詞']
裁判で	['名詞', '助詞']
中止となった	['名詞', '助詞', '動詞', '助動詞']
が集まり	['助詞', '動詞']
に連れて	['助詞', '動詞', '助詞']
を演奏し	['助詞', '名詞', '動詞']
を用意し	['助詞', '名詞', '動詞']
と契約し	['助詞', '名詞', '動詞']
問題がある	['名詞', '助詞', '動詞']
に改められた	['助詞', '動詞', '動詞', '助動詞']
を歌った	['助詞', '動詞', '助動詞']
まれに	['名詞', '助詞']
の一つであり	['助詞', '名詞', '助動詞', '助動詞']
ようとしていた	['名詞', '助詞', '動詞', '助詞', '動詞', '助動詞']
の地点で	['助詞', '名詞', '助詞']
途中から	['名詞', '助詞']
徹底的に	['名詞', '助詞']
に失敗し	['助詞', '名詞', '動詞']
と結婚する	['助詞', '名詞', '動詞']
ものが多く	['名詞', '助詞', '名詞']
の成績を残した	['助詞', '名詞', '助詞', '動詞', '助動詞']
がある場合	['助詞', '動詞', '名詞']
を収めた	['助詞', '動詞', '助動詞']
が進められている	['助詞', '動詞', '動詞', '助詞', '動詞']
と交流	['助詞', '名詞']
を記した	['助詞', '動詞', '助動詞']
に進出し	['助詞', '名詞', '動詞']
を好み	['助詞', '動詞']
を手掛ける	['助詞', '動詞']
に誘われ	['助詞', '動詞', '動詞']
に成立した	['助詞', '名詞', '動詞', '助動詞']
を習得	['助詞', '名詞']
に買収され	['助詞', '名詞', '動詞', '動詞']
として登場する	['助詞', '名詞', '動詞']
に移転し	['助詞', '名詞', '動詞']
内側に	['名詞', '助詞']
を離れて	['助詞', '動詞', '助詞']
を意識した	['助詞', '名詞', '動詞', '助動詞']
は不可能	['助詞', '名詞']
昔から	['名詞', '助詞']
を保護する	['助詞', '名詞', '動詞']
に失敗した	['助詞', '名詞', '動詞', '助動詞']
を創設した	['助詞', '名詞', '動詞', '助動詞']
自らも	['名詞', '助詞']
教育を受け	['名詞', '助詞', '動詞']
を身につけ	['助詞', '名詞', '助詞']
に任ぜられた	['助詞', '名詞', '助詞', '動詞', '助動詞']
に移され	['助詞', '動詞', '動詞']
を見ることができる	['助詞', '動詞', '名詞', '助詞', '動詞']
年に卒業	['名詞', '助詞', '名詞']
へ向けて	['助詞', '動詞', '助詞']
に入学した	['助詞', '名詞', '動詞', '助動詞']
を経由する	['助詞', '名詞', '動詞']
に貢献し	['助詞', '名詞', '動詞']
を占領し	['助詞', '名詞', '動詞']
ゆかりの	['名詞', '助詞']
に分布し	['助詞', '名詞', '動詞']
を持つこと	['助詞', '動詞', '名詞']
現在に至っている	['名詞', '助詞', '動詞', '助詞', '動詞']
を開催し	['助詞', '名詞', '動詞']
を開いて	['助詞', '動詞', '助詞']
を殺害した	['助詞', '名詞', '動詞', '助動詞']
歌手として	['名詞', '助詞']
を増し	['助詞', '動詞']
に合流し	['助詞', '名詞', '動詞']
にちなむ	['助詞', '動詞']
王座を獲得	['名詞', '助詞', '名詞']
事ができる	['名詞', '助詞', '動詞']
もあれば	['助詞', '動詞', '助詞']
ものと思われる	['名詞', '助詞', '動詞', '動詞']
普段は	['名詞', '助詞']
下記の	['名詞', '助詞']
作家として	['名詞', '助詞']
厳密には	['名詞', '助詞', '助詞']
を越えた	['助詞', '動詞', '助動詞']
に任ぜられる	['助詞', '名詞', '助詞', '動詞']
歳で死去した	['名詞', '助詞', '名詞', '動詞', '助動詞']
世紀にかけて	['名詞', '助詞']
が高まった	['助詞', '動詞', '助動詞']
を待つ	['助詞', '動詞']
と評され	['助詞', '動詞', '動詞']
の住人	['助詞', '名詞']
を挙げて	['助詞', '動詞', '助詞']
を設けて	['助詞', '動詞', '助詞']
に異動	['助詞', '名詞']
を含んでいる	['助詞', '動詞', '助詞', '動詞']
年に発表された	['名詞', '助詞', '名詞', '動詞', '動詞', '助動詞']
を目指していた	['助詞', '動詞', '助詞', '動詞', '助動詞']
て来た	['助詞', '動詞', '助動詞']
現代では	['名詞', '助詞', '助詞']
日本の漫画家	['名詞', '助詞', '名詞', '名詞']
に起用され	['助詞', '名詞', '動詞', '動詞']
を殺した	['助詞', '動詞', '助動詞']
を与えて	['助詞', '動詞', '助詞']
に書かれた	['助詞', '動詞', '動詞', '助動詞']
に従った	['助詞', '動詞', '助動詞']
が建てられた	['助詞', '動詞', '動詞', '助動詞']
の最中に	['助詞', '名詞', '助詞']
を得ていた	['助詞', '動詞', '助詞', '動詞', '助動詞']
にちなんだ	['助詞', '動詞', '助動詞']
基ずつ	['名詞', '助詞']
に包まれ	['助詞', '動詞', '動詞']
ことを知る	['名詞', '助詞', '動詞']
注目を浴び	['名詞', '助詞', '動詞']
が目立つ	['助詞', '動詞']
年に初めて	['名詞', '助詞', '副詞']
と題した	['助詞', '動詞', '助動詞']
に敗れる	['助詞', '動詞']
に留まる	['助詞', '動詞']
記述がある	['名詞', '助詞', '動詞']
日に公開された	['名詞', '助詞', '名詞', '動詞', '動詞', '助動詞']
に任せ	['助詞', '動詞']
に復帰する	['助詞', '名詞', '動詞']
日の放送	['名詞', '助詞', '名詞']
優勝に貢献	['名詞', '助詞', '名詞']
を管理する	['助詞', '名詞', '動詞']
銅メダルを獲得した	['名詞', '助詞', '名詞', '動詞', '助動詞']
事が出来る	['名詞', '助詞', '動詞']
を定めた	['助詞', '動詞', '助動詞']
を重ねる	['助詞', '動詞']
年度より	['名詞', '助詞']
に充て	['助詞', '動詞']
と交戦	['助詞', '名詞']
問題について	['名詞', '助詞']
につながった	['助詞', '動詞', '助動詞']
も可能である	['助詞', '名詞', '助動詞', '助動詞']
に学び	['助詞', '動詞']
を破壊する	['助詞', '名詞', '動詞']
ことを理由に	['名詞', '助詞', '名詞', '助詞']
役を演じ	['名詞', '助詞', '動詞']
を止める	['助詞', '動詞']
を通じ	['助詞', '動詞']
を立てた	['助詞', '動詞', '助動詞']
年にフランス	['名詞', '助詞', '名詞']
を促し	['助詞', '動詞']
の紹介で	['助詞', '名詞', '助詞']
に完全移籍	['助詞', '名詞', '名詞']
を決定し	['助詞', '名詞', '動詞']
に反する	['助詞', '動詞']
を作ること	['助詞', '動詞', '名詞']
得点を記録	['名詞', '助詞', '名詞']
を下げ	['助詞', '名詞']
を混ぜ	['助詞', '動詞']
として設立された	['助詞', '名詞', '動詞', '動詞', '助動詞']
を引き起こし	['助詞', '動詞']
日の夜	['名詞', '助詞', '名詞']
注目を集め	['名詞', '助詞', '動詞']
後世の	['名詞', '助詞']
に留まって	['助詞', '動詞', '助詞']
に転身	['助詞', '名詞']
に分かれている	['助詞', '動詞', '助詞', '動詞']
ランキングでは	['名詞', '助詞', '助詞']
によるもので	['助詞', '名詞', '助動詞']
に換装	['助詞', '名詞']
を生んだ	['助詞', '動詞', '助動詞']
を感じる	['助詞', '動詞']
を奪った	['助詞', '動詞', '助動詞']
を感じた	['助詞', '動詞', '助動詞']
に仕える	['助詞', '動詞']
を復活させ	['助詞', '名詞', '動詞', '動詞']
活躍を見せた	['名詞', '助詞', '動詞', '助動詞']
を落とした	['助詞', '動詞', '助動詞']
月に開催された	['名詞', '助詞', '名詞', '動詞', '動詞', '助動詞']
から始まり	['助詞', '名詞']
を指揮した	['助詞', '名詞', '動詞', '助動詞']
に乗った	['助詞', '動詞', '助動詞']
に入ってから	['助詞', '動詞', '助詞', '助詞']
外側に	['名詞', '助詞']
と思って	['助詞', '動詞', '助詞']
をもった	['助詞', '動詞', '助動詞']
を開発する	['助詞', '名詞', '動詞']
を発揮した	['助詞', '名詞', '動詞', '助動詞']
を明確に	['助詞', '名詞', '助詞']
に入れる	['助詞', '動詞']
優勝を果たし	['名詞', '助詞', '動詞']
に置いて	['助詞', '動詞', '助詞']
に匹敵する	['助詞', '名詞', '動詞']
に挑む	['助詞', '動詞']
を引き起こした	['助詞', '動詞', '助動詞']
を名乗った	['助詞', '動詞', '助動詞']
に来る	['助詞', '動詞']
を語る	['助詞', '動詞']
年頃まで	['名詞', '助詞']
を使っている	['助詞', '動詞', '助詞', '動詞']
があげられる	['助詞', '動詞', '動詞']
のあり方	['助詞', '名詞']
人気を博した	['名詞', '助詞', '動詞', '助動詞']
を名乗って	['助詞', '動詞', '助詞']
を命じられた	['助詞', '動詞', '動詞', '助動詞']
が相次いだ	['助詞', '動詞', '助動詞']
に指名され	['助詞', '名詞', '動詞', '動詞']
に留学し	['助詞', '名詞', '動詞']
として活動する	['助詞', '名詞', '動詞']
特徴がある	['名詞', '助詞', '動詞']
に依存する	['助詞', '名詞', '動詞']
に掲載され	['助詞', '名詞', '動詞', '動詞']
を試みる	['助詞', '動詞']
を率い	['助詞', '動詞']
も存在した	['助詞', '名詞', '動詞', '助動詞']
が開かれた	['助詞', '動詞', '動詞', '助動詞']
にとどまり	['助詞', '動詞']
ことを知った	['名詞', '助詞', '動詞', '助動詞']
を知って	['助詞', '動詞', '助詞']
の子として生まれた	['助詞', '名詞', '助詞', '動詞', '助動詞']
短期間で	['名詞', '助詞']
をまとめ	['助詞', '動詞']
を装備する	['助詞', '名詞', '動詞']
活発に	['名詞', '助詞']
にあわせて	['助詞', '動詞', '助詞']
と診断され	['助詞', '名詞', '動詞', '動詞']
に赴き	['助詞', '動詞']
を防ぐために	['助詞', '動詞', '名詞', '助詞']
方法として	['名詞', '助詞']
ことがわかる	['名詞', '助詞', '動詞']
冬に	['名詞', '助詞']
地面に	['名詞', '助詞']
次のような	['名詞', '助詞', '名詞', '助動詞']
賞を受賞し	['名詞', '助詞', '名詞', '動詞']
と題して	['助詞', '動詞', '助詞']
年にイギリス	['名詞', '助詞', '名詞']
ことが明らかになった	['名詞', '助詞', '名詞', '助詞', '動詞', '助動詞']
免許を取得	['名詞', '助詞', '名詞']
市内には	['名詞', '助詞', '助詞']
を敢行	['助詞', '名詞']
を支援し	['助詞', '名詞', '動詞']
最悪の	['名詞', '助詞']
ってくれ	['助詞', '動詞']
経験がある	['名詞', '助詞', '動詞']
に改組	['助詞', '名詞']
というものであった	['助詞', '名詞', '助動詞', '助動詞', '助動詞']
に関与し	['助詞', '名詞', '動詞']
以来となる	['名詞', '助詞', '動詞']
活躍を見せ	['名詞', '助詞', '動詞']
が描かれた	['助詞', '動詞', '動詞', '助動詞']
の子である	['助詞', '名詞', '助動詞', '助動詞']
を発売した	['助詞', '名詞', '動詞', '助動詞']
の門人	['助詞', '名詞']
を調べる	['助詞', '動詞']
の起源は	['助詞', '名詞', '助詞']
を築く	['助詞', '動詞']
を完成させ	['助詞', '名詞', '動詞', '動詞']
面でも	['名詞', '助詞', '助詞']
に入学する	['助詞', '名詞', '動詞']
世紀まで	['名詞', '助詞']
を運ぶ	['助詞', '動詞']
自体も	['名詞', '助詞']
に反対した	['助詞', '名詞', '動詞', '助動詞']
に取り組んだ	['助詞', '動詞', '助動詞']
を志す	['助詞', '動詞']
を読む	['助詞', '動詞']
ものと考えられている	['名詞', '助詞', '動詞', '動詞', '助詞', '動詞']
を終える	['助詞', '動詞']
に疑問	['助詞', '名詞']
に着手した	['助詞', '名詞', '動詞', '助動詞']
を題材とした	['助詞', '名詞', '助詞', '動詞', '助動詞']
を得ること	['助詞', '動詞', '名詞']
を思わせる	['助詞', '動詞', '動詞']
試合に登板して	['名詞', '助詞', '名詞', '動詞', '助詞']
に関連して	['助詞', '名詞', '動詞', '助詞']
明らかになった	['名詞', '助詞', '動詞', '助動詞']
試合に登板	['名詞', '助詞', '名詞']
を覆う	['助詞', '動詞']
を退け	['助詞', '動詞']
に多大な	['助詞', '名詞', '助動詞']
が通っている	['助詞', '動詞', '助詞', '動詞']
に入れて	['助詞', '動詞', '助詞']
に合格し	['助詞', '名詞', '動詞']
に送られ	['助詞', '動詞', '動詞']
の項を参照	['助詞', '名詞', '助詞', '名詞']
直後から	['名詞', '助詞']
年のドラフト	['名詞', '助詞', '名詞']
のことであり	['助詞', '名詞', '助動詞', '助動詞']
の立場から	['助詞', '名詞', '助詞']
に提出し	['助詞', '名詞', '動詞']
を装着し	['助詞', '名詞', '動詞']
の命により	['助詞', '名詞', '助詞']
を抱える	['助詞', '動詞']
と改称した	['助詞', '名詞', '動詞', '助動詞']
に過ぎなかった	['助詞', '動詞', '助動詞', '助動詞']
役割を果たす	['名詞', '助詞', '動詞']
を教える	['助詞', '動詞']
として使われる	['助詞', '動詞', '動詞']
を受け取った	['助詞', '動詞', '助動詞']
詳細に	['名詞', '助詞']
まで務めた	['助詞', '動詞', '助動詞']
一斉に	['名詞', '助詞']
を隠し	['助詞', '動詞']
から離れた	['助詞', '動詞', '助動詞']
後世に	['名詞', '助詞']
の名所	['助詞', '名詞']
を修め	['助詞', '名詞']
が可能となる	['助詞', '名詞', '助詞', '動詞']
に面し	['助詞', '動詞']
を迎えて	['助詞', '動詞', '助詞']
に影響を与えた	['助詞', '名詞', '助詞', '動詞', '助動詞']
と発言した	['助詞', '名詞', '動詞', '助動詞']
を回避する	['助詞', '名詞', '動詞']
で呼ばれる	['助詞', '動詞', '動詞']
を呼ぶ	['助詞', '動詞']
経緯から	['名詞', '助詞']
終盤に	['名詞', '助詞']
と思われた	['助詞', '動詞', '動詞', '助動詞']
を要求し	['助詞', '名詞', '動詞']
年に完成した	['名詞', '助詞', '名詞', '動詞', '助動詞']
んぱ	['助詞', '名詞']
大学に入学	['名詞', '助詞', '名詞']
を開催している	['助詞', '名詞', '動詞', '助詞', '動詞']
を研究する	['助詞', '名詞', '動詞']
に準じ	['助詞', '動詞']
と記され	['助詞', '動詞', '動詞']
の特徴として	['助詞', '名詞', '助詞']
として働く	['助詞', '動詞']
上の問題	['名詞', '助詞', '名詞']
生活を送る	['名詞', '助詞', '動詞']
て行く	['助詞', '動詞']
へ変更	['助詞', '名詞']
に与えた	['助詞', '動詞', '助動詞']
に追われ	['助詞', '動詞', '動詞']
を派遣し	['助詞', '名詞', '動詞']
功績により	['名詞', '助詞']
とよばれる	['助詞', '動詞', '動詞']
ざるを得なかった	['名詞', '助詞', '動詞', '助動詞', '助動詞']
外部から	['名詞', '助詞']
の名残	['助詞', '名詞']
として活動した	['助詞', '名詞', '動詞', '助動詞']
人気のある	['名詞', '助詞', '動詞']
同士で	['名詞', '助詞']
をモデルに	['助詞', '名詞', '助詞']
を述べた	['助詞', '動詞', '助動詞']
を促進する	['助詞', '名詞', '動詞']
を保持する	['助詞', '名詞', '動詞']
を運営している	['助詞', '名詞', '動詞', '助詞', '動詞']
を表し	['助詞', '動詞']
の手によって	['助詞', '名詞', '助詞']
のなかに	['助詞', '名詞', '助詞']
作品を発表	['名詞', '助詞', '名詞']
を伝えた	['助詞', '動詞', '助動詞']
を補う	['助詞', '動詞']
に到達した	['助詞', '名詞', '動詞', '助動詞']
に入団した	['助詞', '名詞', '動詞', '助動詞']
を掌握し	['助詞', '名詞', '動詞']
者もいた	['名詞', '助詞', '動詞', '助動詞']
を襲撃し	['助詞', '名詞', '動詞']
をこなし	['助詞', '動詞']
に触れる	['助詞', '動詞']
も存在し	['助詞', '名詞', '動詞']
ことがない	['名詞', '助詞', '形容詞']
を実現し	['助詞', '名詞', '動詞']
が通る	['助詞', '動詞']
も含まれている	['助詞', '動詞', '動詞', '助詞', '動詞']
勝ちを収め	['名詞', '助詞', '動詞']
という表現	['助詞', '名詞']
ことをきっかけに	['名詞', '助詞', '名詞', '助詞']
に所属している	['助詞', '名詞', '動詞', '助詞', '動詞']
と知り合い	['助詞', '動詞']
を支援した	['助詞', '名詞', '動詞', '助動詞']
を建てた	['助詞', '動詞', '助動詞']
学科を卒業	['名詞', '助詞', '名詞']
に選ばれている	['助詞', '動詞', '動詞', '助詞', '動詞']
下に置かれ	['名詞', '助詞', '動詞', '動詞']
と思われ	['助詞', '動詞', '動詞']
年に発表した	['名詞', '助詞', '名詞', '動詞', '助動詞']
教育を受けた	['名詞', '助詞', '動詞', '助動詞']
を乗り越え	['助詞', '動詞']
夏の甲子園	['名詞', '助詞', '名詞']
に直面し	['助詞', '名詞', '動詞']
性のある	['名詞', '助詞', '動詞']
を変更する	['助詞', '名詞', '動詞']
という意味である	['助詞', '名詞', '助動詞', '助動詞']
で学ぶ	['助詞', '動詞']
に陥って	['助詞', '動詞', '助詞']
に関連した	['助詞', '名詞', '動詞', '助動詞']
を執筆した	['助詞', '名詞', '動詞', '助動詞']
高校を卒業	['名詞', '助詞', '名詞']
に吸収され	['助詞', '名詞', '動詞', '動詞']
を組み合わせて	['助詞', '動詞', '助詞']
を結成する	['助詞', '名詞', '動詞']
入りを果たした	['名詞', '助詞', '動詞', '助動詞']
軍を率いて	['名詞', '助詞', '動詞', '助詞']
ていないため	['助詞', '動詞', '助動詞', '名詞']
を批判した	['助詞', '名詞', '動詞', '助動詞']
として働き	['助詞', '名詞']
を舞台にした	['助詞', '名詞', '助詞', '動詞', '助動詞']
という事実	['助詞', '名詞']
事になった	['名詞', '助詞', '動詞', '助動詞']
に進出する	['助詞', '名詞', '動詞']
に生息し	['助詞', '名詞', '動詞']
を切る	['助詞', '動詞']
を提出した	['助詞', '名詞', '動詞', '助動詞']
を殺す	['助詞', '動詞']
で行われていた	['助詞', '動詞', '動詞', '助詞', '動詞', '助動詞']
を表示する	['助詞', '名詞', '動詞']
ことを認め	['名詞', '助詞', '動詞']
に反して	['助詞', '動詞', '助詞']
大切に	['名詞', '助詞']
賞を獲得	['名詞', '助詞', '名詞']
に参加していた	['助詞', '名詞', '動詞', '助詞', '動詞', '助動詞']
を発見する	['助詞', '名詞', '動詞']
を組んだ	['助詞', '動詞', '助動詞']
に学んだ	['助詞', '動詞', '助動詞']
が決まる	['助詞', '動詞']
に先立って	['助詞', '動詞', '助詞']
を突破し	['助詞', '名詞', '動詞']
を搭載している	['助詞', '名詞', '動詞', '助詞', '動詞']
に入っていた	['助詞', '動詞', '助詞', '動詞', '助動詞']
という条件	['助詞', '名詞']
を開設した	['助詞', '名詞', '動詞', '助動詞']
位置にある	['名詞', '助詞', '動詞']
の影響により	['助詞', '名詞', '助詞']
を名乗り	['助詞', '動詞']
と考えられており	['助詞', '動詞', '動詞', '助詞', '動詞']
得点を記録した	['名詞', '助詞', '名詞', '動詞', '助動詞']
と比較すると	['助詞', '名詞', '動詞', '助詞']
活動を行った	['名詞', '助詞', '動詞', '助動詞']
を供給する	['助詞', '名詞', '動詞']
に送られた	['助詞', '動詞', '動詞', '助動詞']
日に発生した	['名詞', '助詞', '名詞', '動詞', '助動詞']
て以降	['助詞', '名詞']
年に一度	['名詞', '助詞', '名詞', '名詞']
年の時には	['名詞', '助詞', '名詞', '助詞', '助詞']
記録がある	['名詞', '助詞', '動詞']
ことを目的として	['名詞', '助詞', '名詞', '助詞']
を設定し	['助詞', '名詞', '動詞']
へ進出	['助詞', '名詞']
をもうけ	['助詞', '動詞']
に搭載され	['助詞', '名詞', '動詞', '動詞']
に置かれている	['助詞', '動詞', '動詞', '助詞', '動詞']
を撃破し	['助詞', '名詞', '動詞']
を設置している	['助詞', '名詞', '動詞', '助詞', '動詞']
を落とす	['助詞', '動詞']
を輩出し	['助詞', '名詞', '動詞']
ことを知り	['名詞', '助詞', '動詞']
が決まり	['助詞', '動詞']
多くの人	['名詞', '助詞', '名詞']
をおこなった	['助詞', '動詞', '助動詞']
に遭遇し	['助詞', '名詞', '動詞']
を予定していた	['助詞', '名詞', '動詞', '助詞', '動詞', '助動詞']
も積極的に	['助詞', '名詞', '名詞', '助詞']
に移動し	['助詞', '名詞', '動詞']
として発売された	['助詞', '名詞', '動詞', '動詞', '助動詞']
影響を受けている	['名詞', '助詞', '動詞', '助詞', '動詞']
ことが可能である	['名詞', '助詞', '名詞', '助動詞', '助動詞']
力を持つ	['名詞', '助詞', '動詞']
に任じ	['助詞', '動詞']
学校を卒業	['名詞', '助詞', '名詞']
に関する情報	['助詞', '名詞']
に位置しており	['助詞', '名詞', '動詞', '助詞', '動詞']
を著した	['助詞', '動詞', '助動詞']
に架かる	['助詞', '動詞']
を制定し	['助詞', '名詞', '動詞']
を防止する	['助詞', '名詞', '動詞']
という説がある	['助詞', '名詞', '助詞', '動詞']
を持たず	['助詞', '動詞', '助動詞']
に着目し	['助詞', '名詞', '動詞']
に挑戦する	['助詞', '名詞', '動詞']
を確認した	['助詞', '名詞', '動詞', '助動詞']
必要とされる	['名詞', '助詞', '動詞', '動詞']
として参加した	['助詞', '名詞', '動詞', '助動詞']
に先立ち	['助詞', '動詞']
に配属された	['助詞', '名詞', '動詞', '動詞', '助動詞']
に転居	['助詞', '名詞']
以前より	['名詞', '助詞']
ようになっていった	['名詞', '助詞', '動詞', '助詞', '動詞', '助動詞']
を受け取る	['助詞', '動詞']
を込めて	['助詞', '動詞', '助詞']
ことが出来た	['名詞', '助詞', '動詞', '助動詞']
勝利を収め	['名詞', '助詞', '動詞']
を立ち上げた	['助詞', '動詞', '動詞', '助動詞']
に追い込まれた	['助詞', '動詞', '動詞', '助動詞']
を訪問した	['助詞', '名詞', '動詞', '助動詞']
に就き	['助詞', '動詞']
を定める	['助詞', '動詞']
ていくこと	['助詞', '動詞', '名詞']
ものがあり	['名詞', '助詞', '動詞']
として使用される	['助詞', '名詞', '動詞', '動詞']
に基づいている	['助詞', '動詞', '助詞', '動詞']
を訴えた	['助詞', '動詞', '助動詞']
をかけられ	['助詞', '動詞', '動詞']
を模索し	['助詞', '名詞', '動詞']
を成し遂げた	['助詞', '動詞', '助動詞']
に注ぐ	['助詞', '動詞']
に指名された	['助詞', '名詞', '動詞', '動詞', '助動詞']
を製造する	['助詞', '名詞', '動詞']
に通じる	['助詞', '動詞']
と呼んで	['助詞', '動詞', '助詞']
を披露する	['助詞', '名詞', '動詞']
失敗に終わった	['名詞', '助詞', '動詞', '助動詞']
に改称された	['助詞', '名詞', '動詞', '動詞', '助動詞']
に列し	['助詞', '動詞']
を破る	['助詞', '動詞']
に師事した	['助詞', '名詞', '動詞', '助動詞']
を負う	['助詞', '動詞']
を巡り	['助詞', '動詞']
から派生した	['助詞', '名詞', '動詞', '助動詞']
を読んで	['助詞', '動詞', '助詞']
歳の誕生日	['名詞', '助詞', '名詞', '名詞']
人気を集め	['名詞', '助詞', '動詞']
指名を受け	['名詞', '助詞', '動詞']
に面する	['助詞', '動詞']
にかけられ	['助詞', '動詞', '動詞']
年に開催された	['名詞', '助詞', '名詞', '動詞', '動詞', '助動詞']
に改造され	['助詞', '名詞', '動詞', '動詞']
に先駆けて	['助詞', '動詞', '助詞']
に対抗するため	['助詞', '名詞', '動詞', '名詞']
を基にした	['助詞', '名詞', '助詞', '動詞', '助動詞']
銀メダルを獲得した	['名詞', '助詞', '名詞', '動詞', '助動詞']
影響を及ぼす	['名詞', '助詞', '動詞']
本人も	['名詞', '助詞']
子供の頃	['名詞', '助詞', '名詞']
年度まで	['名詞', '助詞']
として活動していた	['助詞', '名詞', '動詞', '助詞', '動詞', '助動詞']
を行わない	['助詞', '動詞', '助動詞']
を強化する	['助詞', '名詞', '動詞']
被害を受け	['名詞', '助詞', '動詞']
という呼称	['助詞', '名詞']
法に基づく	['名詞', '助詞', '動詞']
を完成させた	['助詞', '名詞', '動詞', '動詞', '助動詞']
という意見	['助詞', '名詞']
ということになる	['助詞', '名詞', '助詞', '動詞']
に搭載された	['助詞', '名詞', '動詞', '動詞', '助動詞']
を推進する	['助詞', '名詞', '動詞']
を生産し	['助詞', '名詞', '動詞']
を誇った	['助詞', '動詞', '助動詞']
に接続し	['助詞', '名詞', '動詞']
として活動している	['助詞', '名詞', '動詞', '助詞', '動詞']
を生かし	['助詞', '動詞']
を提案し	['助詞', '名詞', '動詞']
種類がある	['名詞', '助詞', '動詞']
を決めて	['助詞', '動詞', '助詞']
てもらう	['助詞', '動詞']
とみられている	['助詞', '動詞', '動詞', '助詞', '動詞']
とみなされる	['助詞', '動詞', '動詞']
状態にある	['名詞', '助詞', '動詞']
ものと考えられる	['名詞', '助詞', '動詞', '動詞']
の四男	['助詞', '名詞', '名詞']
をつなぐ	['助詞', '動詞']
を生み出した	['助詞', '動詞', '助動詞']
を引き継ぎ	['助詞', '動詞']
を選んで	['助詞', '動詞', '助詞']
が高まる	['助詞', '動詞']
違いがある	['名詞', '助詞', '動詞']
何者か	['名詞', '助詞']
を諦め	['助詞', '動詞']
に転用され	['助詞', '名詞', '動詞', '動詞']
権を獲得した	['名詞', '助詞', '名詞', '動詞', '助動詞']
を創設し	['助詞', '名詞', '動詞']
ことも可能である	['名詞', '助詞', '名詞', '助動詞', '助動詞']
に戻す	['助詞', '動詞']
を含み	['助詞', '動詞']
も登場する	['助詞', '名詞', '動詞']
幼名は	['名詞', '助詞']
月末まで	['名詞', '助詞']
タイトルを獲得した	['名詞', '助詞', '名詞', '動詞', '助動詞']
を冠し	['助詞', '動詞']
とみなす	['助詞', '動詞']
を禁止し	['助詞', '名詞', '動詞']
ことを意味し	['名詞', '助詞', '名詞', '動詞']
として利用されている	['助詞', '名詞', '動詞', '動詞', '助詞', '動詞']
ことはできず	['名詞', '助詞', '動詞', '助動詞']
とその妻	['名詞', '助詞', '名詞']
感銘を受け	['名詞', '助詞', '動詞']
を引き継ぐ	['助詞', '動詞']
に命じて	['助詞', '動詞', '助詞']
を可能にする	['助詞', '名詞', '助詞', '動詞']
と呼んでいた	['助詞', '動詞', '助詞', '動詞', '助動詞']
を打ち出し	['助詞', '動詞']
を否定する	['助詞', '名詞', '動詞']
から生まれた	['助詞', '動詞', '助動詞']
として使用されている	['助詞', '名詞', '動詞', '動詞', '助詞', '動詞']
という地名	['助詞', '名詞']
も盛ん	['助詞', '名詞']
を申請し	['助詞', '名詞', '動詞']
を受け入れる	['助詞', '動詞']
を生かして	['助詞', '動詞', '助詞']
を抱いた	['助詞', '動詞', '助動詞']
を要した	['助詞', '動詞', '助動詞']
を守るために	['助詞', '動詞', '名詞', '助詞']
巻に収録	['名詞', '助詞', '名詞']
勝利を収めた	['名詞', '助詞', '動詞', '助動詞']
に限られる	['助詞', '動詞', '動詞']
を確認し	['助詞', '名詞', '動詞']
に身を	['助詞', '名詞', '助詞']
を生み出し	['助詞', '動詞']
を達成する	['助詞', '名詞', '動詞']
を確保するため	['助詞', '名詞', '動詞', '名詞']
有名になった	['名詞', '助詞', '動詞', '助動詞']
世界中に	['名詞', '助詞']
を阻止する	['助詞', '名詞', '動詞']
が可能になった	['助詞', '名詞', '助詞', '動詞', '助動詞']
をあげる	['助詞', '動詞']
に関わらず	['助詞', '動詞', '助動詞']
に参戦した	['助詞', '名詞', '動詞', '助動詞']
許可を得	['名詞', '助詞', '名詞']
を抱いて	['助詞', '動詞', '助詞']
をみせ	['助詞', '動詞']
を建立し	['助詞', '名詞', '動詞']
厳密に	['名詞', '助詞']
理由について	['名詞', '助詞']
と語る	['助詞', '動詞']
も検討	['助詞', '名詞']
ことが挙げられる	['名詞', '助詞', '動詞', '動詞']
を問う	['助詞', '動詞']
を活用し	['助詞', '名詞', '動詞']
を図っている	['助詞', '動詞', '助詞', '動詞']
の勧めで	['助詞', '名詞', '助詞']
にまたがる	['助詞', '動詞']
速やかに	['名詞', '助詞']
を与えること	['助詞', '動詞', '名詞']
と協力して	['助詞', '名詞', '動詞', '助詞']
名を冠した	['名詞', '助詞', '動詞', '助動詞']
度の高い	['名詞', '助詞', '形容詞']
を提唱した	['助詞', '名詞', '動詞', '助動詞']
にすぎない	['助詞', '動詞', '助動詞']
の創始者	['助詞', '名詞', '名詞']
による日本の漫画作品	['助詞', '名詞', '助詞', '名詞', '名詞']
として働いた	['助詞', '動詞', '助動詞']
に含まれている	['助詞', '動詞', '動詞', '助詞', '動詞']
に遡る	['助詞', '動詞']
盗塁を記録した	['名詞', '助詞', '名詞', '動詞', '助動詞']
と見なし	['助詞', '動詞']
にかかわらず	['助詞', '動詞', '助動詞']
へ復帰	['助詞', '名詞']
の中にある	['助詞', '名詞', '助詞', '動詞']
にちなみ	['助詞', '動詞']
を可能にし	['助詞', '名詞', '助詞', '動詞']
を極め	['助詞', '名詞']
になりたい	['助詞', '動詞', '助動詞']
に併合され	['助詞', '名詞', '動詞', '動詞']
に限って	['助詞', '動詞', '助詞']
記録を樹立	['名詞', '助詞', '名詞']
として活躍する	['助詞', '名詞', '動詞']
歳にして	['名詞', '助詞', '動詞', '助詞']
を開催する	['助詞', '名詞', '動詞']
を保ち	['助詞', '動詞']
以下のような	['名詞', '助詞', '名詞', '助動詞']
を発する	['助詞', '動詞']
を中止し	['助詞', '名詞', '動詞']
それに対して	['名詞', '助詞']
を待って	['助詞', '動詞', '助詞']
に置いた	['助詞', '動詞', '助動詞']
を進めている	['助詞', '動詞', '助詞', '動詞']
必要に応じて	['名詞', '助詞', '動詞', '助詞']
を教えた	['助詞', '動詞', '助動詞']
幾つか	['名詞', '助詞']
後を継いだ	['名詞', '助詞', '動詞', '助動詞']
大学へ進学	['名詞', '助詞', '名詞']
に委ね	['助詞', '動詞']
を支配した	['助詞', '名詞', '動詞', '助動詞']
を放送する	['助詞', '名詞', '動詞']
服を着	['名詞', '助詞', '名詞']
世界で最も	['名詞', '助詞', '副詞']
ておく	['助詞', '動詞']
日本で初めて	['名詞', '助詞', '副詞']
を投入し	['助詞', '名詞', '動詞']
人気がある	['名詞', '助詞', '動詞']
代表として出場	['名詞', '助詞', '名詞']
に接近し	['助詞', '名詞', '動詞']
へ完全移籍	['助詞', '名詞', '名詞']
と接している	['助詞', '動詞', '助詞', '動詞']
を多用し	['助詞', '名詞', '動詞']
と共演した	['助詞', '名詞', '動詞', '助動詞']
を計画した	['助詞', '名詞', '動詞', '助動詞']
を行なって	['助詞', '動詞', '助詞']
を発症し	['助詞', '名詞', '動詞']
が必要になる	['助詞', '名詞', '助詞', '動詞']
活動を始める	['名詞', '助詞', '動詞']
いつでも	['名詞', '助詞', '助詞']
現時点で	['名詞', '助詞']
ざるを得ない	['名詞', '助詞', '動詞', '助動詞']
に挟まれた	['助詞', '動詞', '動詞', '助動詞']
を批判する	['助詞', '名詞', '動詞']
を率いた	['助詞', '動詞', '助動詞']
を宣言し	['助詞', '名詞', '動詞']
永遠の	['名詞', '助詞']
を目標に	['助詞', '名詞', '助詞']
を流し	['助詞', '動詞']
を依頼した	['助詞', '名詞', '動詞', '助動詞']
に移動した	['助詞', '名詞', '動詞', '助動詞']
を置いている	['助詞', '動詞', '助詞', '動詞']
に上る	['助詞', '動詞']
に関係する	['助詞', '名詞', '動詞']
を意識し	['助詞', '名詞', '動詞']
を実行する	['助詞', '名詞', '動詞']
に興味を持ち	['助詞', '名詞', '助詞', '動詞']
を競う	['助詞', '動詞']
を離れる	['助詞', '動詞']
を繰り広げ	['助詞', '動詞']
を買収した	['助詞', '名詞', '動詞', '助動詞']
に突入し	['助詞', '名詞', '動詞']
川の支流	['名詞', '助詞', '名詞']
を高めた	['助詞', '動詞', '助動詞']
に出向	['助詞', '名詞']
も使われる	['助詞', '動詞', '動詞']
を併せ	['助詞', '動詞']
出場を果たし	['名詞', '助詞', '動詞']
に移行する	['助詞', '名詞', '動詞']
を流用し	['助詞', '名詞', '動詞']
タイトルを獲得	['名詞', '助詞', '名詞']
を訴える	['助詞', '動詞']
に関与した	['助詞', '名詞', '動詞', '助動詞']
へ加入	['助詞', '名詞']
を結んで	['助詞', '動詞', '助詞']
に参加して	['助詞', '名詞', '動詞', '助詞']
場合もあり	['名詞', '助詞', '動詞']
の指導を受け	['助詞', '名詞', '助詞', '動詞']
を抑制する	['助詞', '名詞', '動詞']
を採って	['助詞', '動詞', '助詞']
を提出し	['助詞', '名詞', '動詞']
を殺害し	['助詞', '名詞', '動詞']
を実現した	['助詞', '名詞', '動詞', '助動詞']
に名を連ね	['助詞', '名詞', '助詞', '動詞']
ことがきっかけで	['名詞', '助詞', '名詞', '助詞']
を挟み	['助詞', '動詞']
を守るため	['助詞', '動詞', '名詞']
役割を果たし	['名詞', '助詞', '動詞']
とコメントしている	['助詞', '名詞', '動詞', '助詞', '動詞']
を繰り広げる	['助詞', '動詞']
として知られていた	['助詞', '動詞', '動詞', '助詞', '動詞', '助動詞']
を交わし	['助詞', '動詞']
に貢献する	['助詞', '名詞', '動詞']
を測定する	['助詞', '名詞', '動詞']
を突破した	['助詞', '名詞', '動詞', '助動詞']
に置かれる	['助詞', '動詞', '動詞']
を追加した	['助詞', '名詞', '動詞', '助動詞']
ことを明らかにした	['名詞', '助詞', '名詞', '助詞', '動詞', '助動詞']
をおこなう	['助詞', '動詞']
を得るために	['助詞', '動詞', '名詞', '助詞']
差をつけ	['名詞', '助詞', '名詞']
話題になった	['名詞', '助詞', '動詞', '助動詞']
を構築する	['助詞', '名詞', '動詞']
工事が行われ	['名詞', '助詞', '動詞', '動詞']
と表現し	['助詞', '名詞', '動詞']
城の戦い	['名詞', '助詞', '名詞']
を買う	['助詞', '動詞']
数は約	['名詞', '助詞', '接頭詞']
を免れた	['助詞', '動詞', '助動詞']
を伴って	['助詞', '動詞', '助詞']
年に出版された	['名詞', '助詞', '名詞', '動詞', '動詞', '助動詞']
へ向かい	['助詞', '動詞']
の背後に	['助詞', '名詞', '助詞']
を対象とし	['助詞', '名詞', '助詞', '動詞']
が増えている	['助詞', '動詞', '助詞', '動詞']
をつくり	['助詞', '動詞']
を買って	['助詞', '動詞', '助詞']
学校に入学	['名詞', '助詞', '名詞']
を整備し	['助詞', '名詞', '動詞']
を理解し	['助詞', '名詞', '動詞']
よこ	['助詞', '名詞']
を継承する	['助詞', '名詞', '動詞']
人気を博し	['名詞', '助詞', '動詞']
意見もある	['名詞', '助詞', '動詞']
を調査し	['助詞', '名詞', '動詞']
に面している	['助詞', '動詞', '助詞', '動詞']
を制御する	['助詞', '名詞', '動詞']
に移した	['助詞', '動詞', '助動詞']
に乗じて	['助詞', '動詞', '助詞']
を生む	['助詞', '動詞']
として使用する	['助詞', '名詞', '動詞']
というものだった	['助詞', '名詞', '助動詞', '助動詞']
を設置して	['助詞', '名詞', '動詞', '助詞']
と話している	['助詞', '動詞', '助詞', '動詞']
と対戦する	['助詞', '名詞', '動詞']
必要はない	['名詞', '助詞', '形容詞']
を恐れて	['助詞', '動詞', '助詞']
に反発し	['助詞', '名詞', '動詞']
ここまで	['名詞', '助詞']
を称し	['助詞', '動詞']
恐れがある	['名詞', '助詞', '動詞']
を含んで	['助詞', '動詞', '助詞']
の総称である	['助詞', '名詞', '助動詞', '助動詞']
を許され	['助詞', '動詞', '動詞']
を得意とする	['助詞', '名詞', '助詞', '動詞']
を基本とし	['助詞', '名詞', '助詞', '動詞']
処分を受けた	['名詞', '助詞', '動詞', '助動詞']
が高まって	['助詞', '動詞', '助詞']
に本社を置く	['助詞', '名詞', '助詞', '動詞']
を取っている	['助詞', '動詞', '助詞', '動詞']
を受け入れた	['助詞', '動詞', '助動詞']
を取ら	['助詞', '動詞']
成績を収め	['名詞', '助詞', '動詞']
を目撃し	['助詞', '名詞', '動詞']
に追い込まれ	['助詞', '動詞', '動詞']
いくつもの	['名詞', '助詞', '助詞']
を免れ	['助詞', '動詞']
を呈する	['助詞', '動詞']
を取り戻し	['助詞', '動詞']
を設けている	['助詞', '動詞', '助詞', '動詞']
を確保した	['助詞', '名詞', '動詞', '助動詞']
を確立し	['助詞', '名詞', '動詞']
自身のブログ	['名詞', '助詞', '名詞']
を拠点とする	['助詞', '名詞', '助詞', '動詞']
へ移り	['助詞', '動詞']
を通過した	['助詞', '名詞', '動詞', '助動詞']
が終わると	['助詞', '動詞', '助詞']
に配慮し	['助詞', '名詞', '動詞']
を守って	['助詞', '動詞', '助詞']
を流す	['助詞', '動詞']
時期もあった	['名詞', '助詞', '動詞', '助動詞']
として利用される	['助詞', '名詞', '動詞', '動詞']
と名付けられ	['助詞', '動詞', '動詞']
金メダルを獲得	['名詞', '助詞', '名詞']
を利用している	['助詞', '名詞', '動詞', '助詞', '動詞']
を見つけた	['助詞', '動詞', '助動詞']
を共有し	['助詞', '名詞', '動詞']
分野において	['名詞', '助詞']
語を話す	['名詞', '助詞', '動詞']
を移した	['助詞', '動詞', '助動詞']
を進めていた	['助詞', '動詞', '助詞', '動詞', '助動詞']
跡を継いだ	['名詞', '助詞', '動詞', '助動詞']
に駐屯し	['助詞', '名詞', '動詞']
に改めた	['助詞', '動詞', '助動詞']
能力を持つ	['名詞', '助詞', '動詞']
を祝う	['助詞', '動詞']
を抱いていた	['助詞', '動詞', '助詞', '動詞', '助動詞']
いくらか	['名詞', '助詞']
人もいる	['名詞', '助詞', '動詞']
を学んで	['助詞', '動詞', '助詞']
と推定され	['助詞', '名詞', '動詞', '動詞']
を称した	['助詞', '動詞', '助動詞']
これを受け	['名詞', '助詞', '動詞']
を握る	['助詞', '動詞']
を運営し	['助詞', '名詞', '動詞']
に関係なく	['助詞', '名詞', '形容詞']
を守った	['助詞', '動詞', '助動詞']
に出席し	['助詞', '名詞', '動詞']
を恐れた	['助詞', '動詞', '助動詞']
以外でも	['名詞', '助詞', '助詞']
に登場する架空の	['助詞', '名詞', '動詞', '名詞', '助詞']
語に翻訳	['名詞', '助詞', '名詞']
を供給し	['助詞', '名詞', '動詞']
によって設立された	['助詞', '名詞', '動詞', '動詞', '助動詞']
を占めていた	['助詞', '動詞', '助詞', '動詞', '助動詞']
を取り戻した	['助詞', '動詞', '助動詞']
姿を消し	['名詞', '助詞', '動詞']
かたちで	['名詞', '助詞']
の先駆け	['助詞', '名詞']
とする説がある	['助詞', '動詞', '名詞', '助詞', '動詞']
を讃え	['助詞', '動詞']
会長を務めた	['名詞', '助詞', '動詞', '助動詞']
ていなかったため	['助詞', '動詞', '助動詞', '助動詞', '名詞']
を輩出した	['助詞', '名詞', '動詞', '助動詞']
監督を務める	['名詞', '助詞', '動詞']
を証明する	['助詞', '名詞', '動詞']
を費やし	['助詞', '動詞']
勝ちを収めた	['名詞', '助詞', '動詞', '助動詞']
も務める	['助詞', '動詞']
を占めた	['助詞', '動詞', '助動詞']
ことも多く	['名詞', '助詞', '名詞']
とその周辺	['名詞', '助詞', '名詞']
を排除し	['助詞', '名詞', '動詞']
を維持した	['助詞', '名詞', '動詞', '助動詞']
を記念し	['助詞', '名詞', '動詞']
を活かした	['助詞', '動詞', '助動詞']
を舞台とした	['助詞', '名詞', '助詞', '動詞', '助動詞']
当初より	['名詞', '助詞']
と判断され	['助詞', '名詞', '動詞', '動詞']
頭角を現し	['名詞', '助詞', '動詞']
が相次ぎ	['助詞', '動詞']
日に放送された	['名詞', '助詞', '名詞', '動詞', '動詞', '助動詞']
のことを指す	['助詞', '名詞', '助詞', '動詞']
がついている	['助詞', '動詞', '助詞', '動詞']
と違って	['助詞', '動詞', '助詞']
議席を獲得	['名詞', '助詞', '名詞']
を授与され	['助詞', '名詞', '動詞', '動詞']
も同様である	['助詞', '名詞', '助動詞', '助動詞']
は存在せず	['助詞', '名詞', '動詞', '助動詞']
を兼ねる	['助詞', '動詞']
上の理由	['名詞', '助詞', '名詞']
遥かに	['名詞', '助詞']
活動を休止	['名詞', '助詞', '名詞']
に満ちた	['助詞', '動詞', '助動詞']
を渡って	['助詞', '動詞', '助詞']
が加わり	['助詞', '動詞']
で働いていた	['助詞', '動詞', '助詞', '動詞', '助動詞']
世界で初めて	['名詞', '助詞', '副詞']
指揮を執っ	['名詞', '助詞', '動詞']
を著し	['助詞', '動詞']
所定の	['名詞', '助詞']
事もあり	['名詞', '助詞', '動詞']
を駆使し	['助詞', '名詞', '動詞']
生計を立て	['名詞', '助詞', '動詞']
を与えている	['助詞', '動詞', '助詞', '動詞']
を無視し	['助詞', '名詞', '動詞']
を廃し	['助詞', '動詞']
に引き継がれた	['助詞', '動詞', '動詞', '助動詞']
ものとされる	['名詞', '助詞', '動詞', '動詞']
を任せ	['助詞', '動詞']
年に公開された	['名詞', '助詞', '名詞', '動詞', '動詞', '助動詞']
として知られた	['助詞', '動詞', '動詞', '助動詞']
を成立させ	['助詞', '名詞', '動詞', '動詞']
を対象とする	['助詞', '名詞', '助詞', '動詞']
を目的とし	['助詞', '名詞', '助詞', '動詞']
に過ぎず	['助詞', '動詞', '助動詞']
に到達する	['助詞', '名詞', '動詞']
の協力を得て	['助詞', '名詞', '助詞', '動詞', '助詞']
を前提に	['助詞', '名詞', '助詞']
を通じた	['助詞', '動詞', '助動詞']
年に創設された	['名詞', '助詞', '名詞', '動詞', '動詞', '助動詞']
を武器に	['助詞', '名詞', '助詞']
が敷かれ	['助詞', '動詞', '動詞']
支持を得	['名詞', '助詞', '名詞']
ことが分かる	['名詞', '助詞', '動詞']
の病院で死去	['助詞', '名詞', '助詞', '名詞']
を踏む	['助詞', '動詞']
優勝を果たす	['名詞', '助詞', '動詞']
という考え方	['助詞', '名詞']
国の史跡	['名詞', '助詞', '名詞']
と説明している	['助詞', '名詞', '動詞', '助詞', '動詞']
を繰り広げた	['助詞', '動詞', '助動詞']
位に入り	['名詞', '助詞', '動詞']
を示していた	['助詞', '動詞', '助詞', '動詞', '助動詞']
試合の登板	['名詞', '助詞', '名詞']
に注目し	['助詞', '名詞', '動詞']
ことを考え	['名詞', '助詞', '動詞']
に携わり	['助詞', '動詞']
をとっていた	['助詞', '動詞', '助詞', '動詞', '助動詞']
について述べる	['助詞', '動詞']
洗礼を受け	['名詞', '助詞', '動詞']
に因む	['助詞', '動詞']
を抑えて	['助詞', '動詞', '助詞']
に率いられ	['助詞', '動詞', '動詞']
になろう	['助詞', '動詞', '助動詞']
という噂	['助詞', '名詞']
を基調とし	['助詞', '名詞', '助詞', '動詞']
の影響を受けて	['助詞', '名詞', '助詞', '動詞', '助詞']
を着て	['助詞', '動詞', '助詞']
を許された	['助詞', '動詞', '動詞', '助動詞']
を避けて	['助詞', '動詞', '助詞']
を吸収し	['助詞', '名詞', '動詞']
を表した	['助詞', '動詞', '助動詞']
を助けた	['助詞', '動詞', '助動詞']
と命名され	['助詞', '名詞', '動詞', '動詞']
に住んだ	['助詞', '動詞', '助動詞']
にとどまる	['助詞', '動詞']
に見立て	['助詞', '名詞']
を施す	['助詞', '動詞']
無数の	['名詞', '助詞']
を決意した	['助詞', '名詞', '動詞', '助動詞']
と評された	['助詞', '動詞', '動詞', '助動詞']
義理の	['名詞', '助詞']
を征服し	['助詞', '名詞', '動詞']
を乗せた	['助詞', '動詞', '助動詞']
ことが分かった	['名詞', '助詞', '動詞', '助動詞']
これを機に	['名詞', '助詞', '名詞', '助詞']
が可能となっている	['助詞', '名詞', '助詞', '動詞', '助詞', '動詞']
を手に入れ	['助詞', '名詞', '助詞', '動詞']
を編成し	['助詞', '名詞', '動詞']
に扮し	['助詞', '動詞']
勝を挙げた	['名詞', '助詞', '動詞', '助動詞']
を向上させる	['助詞', '名詞', '動詞', '動詞']
兵を率いて	['名詞', '助詞', '動詞', '助詞']
役割を果たしている	['名詞', '助詞', '動詞', '助詞', '動詞']
に対抗して	['助詞', '名詞', '動詞', '助詞']
が置かれていた	['助詞', '動詞', '動詞', '助詞', '動詞', '助動詞']
に移す	['助詞', '動詞']
を強調する	['助詞', '名詞', '動詞']
と言っている	['助詞', '動詞', '助詞', '動詞']
に移管され	['助詞', '名詞', '動詞', '動詞']
を構える	['助詞', '動詞']
を選択した	['助詞', '名詞', '動詞', '助動詞']
ことのない	['名詞', '助詞', '形容詞']
それに伴う	['名詞', '助詞', '動詞']
に同行し	['助詞', '名詞', '動詞']
を指摘し	['助詞', '名詞', '動詞']
に対抗し	['助詞', '名詞', '動詞']
に準じた	['助詞', '動詞', '助動詞']
に浮かぶ	['助詞', '動詞']
と判断された	['助詞', '名詞', '動詞', '動詞', '助動詞']
にて行われた	['助詞', '動詞', '動詞', '助動詞']
を更新し	['助詞', '名詞', '動詞']
を襲った	['助詞', '動詞', '助動詞']
ものもあり	['名詞', '助詞', '動詞']
を維持するため	['助詞', '名詞', '動詞', '名詞']
を取り巻く	['助詞', '動詞']
の周りに	['助詞', '名詞', '助詞']
に晒され	['助詞', '動詞', '動詞']
にて死去	['助詞', '名詞']
ために必要な	['名詞', '助詞', '名詞', '助動詞']
事故を起こし	['名詞', '助詞', '動詞']
は以下の通り	['助詞', '名詞', '助詞', '名詞']
を手に入れた	['助詞', '名詞', '助詞', '動詞', '助動詞']
影響を受ける	['名詞', '助詞', '動詞']
を生産する	['助詞', '名詞', '動詞']
と評される	['助詞', '動詞', '動詞']
日本の政治家	['名詞', '助詞', '名詞', '名詞']
を採用しており	['助詞', '名詞', '動詞', '助詞', '動詞']
にかかわる	['助詞', '動詞']
を有しており	['助詞', '動詞', '助詞', '動詞']
問題を抱え	['名詞', '助詞', '名詞']
を改善する	['助詞', '名詞', '動詞']
を唱える	['助詞', '動詞']
を阻害する	['助詞', '名詞', '動詞']
を撤去し	['助詞', '名詞', '動詞']
におよぶ	['助詞', '動詞']
今日でも	['名詞', '助詞', '助詞']
ってしまい	['助詞', '動詞']
を要請した	['助詞', '名詞', '動詞', '助動詞']
を管轄する	['助詞', '名詞', '動詞']
に変換する	['助詞', '名詞', '動詞']
発祥の地	['名詞', '助詞', '名詞']
になれ	['助詞', '動詞']
を理解する	['助詞', '名詞', '動詞']
と思います	['助詞', '動詞', '助動詞']
へ入社	['助詞', '名詞']
を配し	['助詞', '動詞']
同種の	['名詞', '助詞']
ことを示した	['名詞', '助詞', '動詞', '助動詞']
も含まれていた	['助詞', '動詞', '動詞', '助詞', '動詞', '助動詞']
に寄与する	['助詞', '名詞', '動詞']
を公表した	['助詞', '名詞', '動詞', '助動詞']
試合に登板した	['名詞', '助詞', '名詞', '動詞', '助動詞']
を示唆する	['助詞', '名詞', '動詞']
を説得し	['助詞', '名詞', '動詞']
注目を集める	['名詞', '助詞', '動詞']
ことも可能	['名詞', '助詞', '名詞']
へ異動	['助詞', '名詞']
を成す	['助詞', '動詞']
から来ている	['助詞', '動詞', '助詞', '動詞']
大会で優勝	['名詞', '助詞', '名詞']
多岐にわたる	['名詞', '助詞']
を愛し	['助詞', '動詞']
資格を取得	['名詞', '助詞', '名詞']
廃車となった	['名詞', '助詞', '動詞', '助動詞']
非常に高い	['名詞', '助詞', '形容詞']
に設置される	['助詞', '名詞', '動詞', '動詞']
年代に入って	['名詞', '助詞', '動詞', '助詞']
契約を結ぶ	['名詞', '助詞', '動詞']
上記のように	['名詞', '助詞', '名詞', '助詞']
を囲む	['助詞', '動詞']
区から出馬し	['名詞', '助詞', '名詞', '動詞']
に於ける	['助詞', '動詞', '助動詞']
に戻された	['助詞', '動詞', '動詞', '助動詞']
に値する	['助詞', '動詞']
を示唆し	['助詞', '名詞', '動詞']
を増加させ	['助詞', '名詞', '動詞', '動詞']
ことを決めた	['名詞', '助詞', '動詞', '助動詞']
を作り出す	['助詞', '動詞']
が加えられた	['助詞', '動詞', '動詞', '助動詞']
を挟んだ	['助詞', '動詞', '助動詞']
を追求し	['助詞', '名詞', '動詞']
を向上させ	['助詞', '名詞', '動詞', '動詞']
を継続する	['助詞', '名詞', '動詞']
氏の一族	['名詞', '助詞', '名詞']
を非難し	['助詞', '名詞', '動詞']
を送っている	['助詞', '動詞', '助詞', '動詞']
を解消し	['助詞', '名詞', '動詞']
を負い	['助詞', '動詞']
へ至る	['助詞', '動詞']
を備えていた	['助詞', '動詞', '助詞', '動詞', '助動詞']
月に発売された	['名詞', '助詞', '名詞', '動詞', '動詞', '助動詞']
を埋める	['助詞', '動詞']
に臨む	['助詞', '動詞']
に踏み切	['助詞', '動詞']
てもらえ	['助詞', '動詞']
主将を務め	['名詞', '助詞', '名詞']
を提唱し	['助詞', '名詞', '動詞']
となってしまう	['助詞', '動詞', '助詞', '動詞']
を保った	['助詞', '動詞', '助動詞']
に上陸した	['助詞', '名詞', '動詞', '助動詞']
に移管された	['助詞', '名詞', '動詞', '動詞', '助動詞']
静かに	['名詞', '助詞']
生活を送っていた	['名詞', '助詞', '動詞', '助詞', '動詞', '助動詞']
詳細は不明	['名詞', '助詞', '名詞']
を変化させ	['助詞', '名詞', '動詞', '動詞']
を積む	['助詞', '動詞']
を説明し	['助詞', '名詞', '動詞']
を生み	['助詞', '名詞']
に転任	['助詞', '名詞']
を承認した	['助詞', '名詞', '動詞', '助動詞']
を操作し	['助詞', '名詞', '動詞']
が義務付けられ	['助詞', '動詞', '動詞']
を目標とし	['助詞', '名詞', '助詞', '動詞']
を行ない	['助詞', '動詞']
に至っている	['助詞', '動詞', '助詞', '動詞']
に尽力し	['助詞', '名詞', '動詞']
を立ち上げる	['助詞', '動詞', '動詞']
刑に処	['名詞', '助詞', '名詞']
に焦点を当て	['助詞', '名詞', '助詞', '副詞']
運行を開始した	['名詞', '助詞', '名詞', '動詞', '助動詞']
道の駅	['名詞', '助詞', '名詞']
を攻略し	['助詞', '名詞', '動詞']
ことをいう	['名詞', '助詞', '動詞']
狭義の	['名詞', '助詞']
を活用した	['助詞', '名詞', '動詞', '助動詞']
学を学んだ	['名詞', '助詞', '動詞', '助動詞']
の流れを汲む	['助詞', '名詞', '助詞', '動詞']
を引用し	['助詞', '名詞', '動詞']
に派遣し	['助詞', '名詞', '動詞']
ことがなかった	['名詞', '助詞', '形容詞', '助動詞']
とコメントした	['助詞', '名詞', '動詞', '助動詞']
を担い	['助詞', '動詞']
を喫する	['助詞', '動詞']
を隠す	['助詞', '動詞']
が置かれる	['助詞', '動詞', '動詞']
勢力を拡大	['名詞', '助詞', '名詞']
を駆使して	['助詞', '名詞', '動詞', '助詞']
という逸話	['助詞', '名詞']
県を管轄した	['名詞', '助詞', '名詞', '動詞', '助動詞']
を重んじ	['助詞', '動詞']
に言及し	['助詞', '名詞', '動詞']
に置かれていた	['助詞', '動詞', '動詞', '助詞', '動詞', '助動詞']
に赴いた	['助詞', '動詞', '助動詞']
を極めた	['助詞', '動詞', '助動詞']
年間にわたって	['名詞', '助詞']
を成し	['助詞', '動詞']
まで遡る	['助詞', '動詞']
花期は	['名詞', '助詞']
学を専攻	['名詞', '助詞', '名詞']
を広げる	['助詞', '動詞']
に触発され	['助詞', '名詞', '動詞', '動詞']
計画を立て	['名詞', '助詞', '動詞']
強引に	['名詞', '助詞']
が可能になる	['助詞', '名詞', '助詞', '動詞']
を解く	['助詞', '動詞']
銅メダルを獲得	['名詞', '助詞', '名詞']
を取っていた	['助詞', '動詞', '助詞', '動詞', '助動詞']
を論じ	['助詞', '動詞']
を着用する	['助詞', '名詞', '動詞']
に協力した	['助詞', '名詞', '動詞', '助動詞']
を繋ぐ	['助詞', '動詞']
川に合流する	['名詞', '助詞', '名詞', '動詞']
にとどまらず	['助詞', '動詞', '助動詞']
を禁止する	['助詞', '名詞', '動詞']
に乗り出した	['助詞', '動詞', '助動詞']
ことが原因	['名詞', '助詞', '名詞']
を採用していた	['助詞', '名詞', '動詞', '助詞', '動詞', '助動詞']
を軸に	['助詞', '名詞', '助詞']
を手に入れる	['助詞', '名詞', '助詞', '動詞']
等を歴任	['名詞', '助詞', '名詞']
を無視して	['助詞', '名詞', '動詞', '助詞']
に先立つ	['助詞', '動詞']
を経営する	['助詞', '名詞', '動詞']
を共有する	['助詞', '名詞', '動詞']
を捕食する	['助詞', '名詞', '動詞']
を管理し	['助詞', '名詞', '動詞']
と発言している	['助詞', '名詞', '動詞', '助詞', '動詞']
を入手し	['助詞', '名詞', '動詞']
最寄りの	['名詞', '助詞']
に役立つ	['助詞', '動詞']
幼少の頃	['名詞', '助詞', '名詞']
反乱を起こした	['名詞', '助詞', '動詞', '助動詞']
影響を与えている	['名詞', '助詞', '動詞', '助詞', '動詞']
随所に	['名詞', '助詞']
エンジンを搭載した	['名詞', '助詞', '名詞', '動詞', '助動詞']
最大の特徴	['名詞', '助詞', '名詞']
を被った	['助詞', '動詞', '助動詞']
どれだけ	['名詞', '助詞']
自力で	['名詞', '助詞']
を告げる	['助詞', '動詞']
を固めた	['助詞', '動詞', '助動詞']
を筆頭に	['助詞', '名詞', '助詞']
の子として生まれる	['助詞', '名詞', '助詞', '動詞']
契約を交わし	['名詞', '助詞', '動詞']
を数える	['助詞', '動詞']
へ向かって	['助詞', '動詞', '助詞']
を司る	['助詞', '動詞']
の都合で	['助詞', '名詞', '助詞']
を持たせる	['助詞', '動詞', '動詞']
を営んでいた	['助詞', '動詞', '助詞', '動詞', '助動詞']
を傷つけ	['助詞', '動詞']
着実に	['名詞', '助詞']
少尉に任官	['名詞', '助詞', '名詞']
を拒否する	['助詞', '名詞', '動詞']
を発生させる	['助詞', '名詞', '動詞', '動詞']
を拠点とし	['助詞', '名詞', '助詞', '動詞']
ことを指摘し	['名詞', '助詞', '名詞', '動詞']
かわりに	['名詞', '助詞']
を下げる	['助詞', '動詞']
を希望する	['助詞', '名詞', '動詞']
てもらった	['助詞', '動詞', '助動詞']
長を歴任	['名詞', '助詞', '名詞']
に騎乗し	['助詞', '名詞', '動詞']
を擁立し	['助詞', '名詞', '動詞']
同郷の	['名詞', '助詞']
へ進む	['助詞', '動詞']
が必要だ	['助詞', '名詞', '助動詞']
を辞し	['助詞', '動詞']
を操作する	['助詞', '名詞', '動詞']
試合に先発	['名詞', '助詞', '名詞']
を握った	['助詞', '動詞', '助動詞']
を統括する	['助詞', '名詞', '動詞']
に入れられ	['助詞', '動詞', '動詞']
に富んだ	['助詞', '動詞', '助動詞']
をさす	['助詞', '動詞']
に戻され	['助詞', '動詞', '動詞']
と指摘した	['助詞', '名詞', '動詞', '助動詞']
年の総選挙で	['名詞', '助詞', '接頭詞', '名詞', '助詞']
位に入賞	['名詞', '助詞', '名詞']
を樹立し	['助詞', '名詞', '動詞']
を引いて	['助詞', '動詞', '助詞']
内訳は	['名詞', '助詞']
と名乗って	['助詞', '動詞', '助詞']
を賜った	['助詞', '動詞', '助動詞']
を過ぎて	['助詞', '動詞', '助詞']
と題する	['助詞', '動詞']
に適している	['助詞', '動詞', '助詞', '動詞']
町に接する	['名詞', '助詞', '動詞']
部に入部	['名詞', '助詞', '名詞']
を発足させ	['助詞', '名詞', '動詞', '動詞']
と批判した	['助詞', '名詞', '動詞', '助動詞']
着に終わった	['名詞', '助詞', '動詞', '助動詞']
姿を見せ	['名詞', '助詞', '動詞']
を起点とし	['助詞', '名詞', '助詞', '動詞']
着に敗れ	['名詞', '助詞', '動詞']
と呼ぶこともある	['助詞', '動詞', '名詞', '助詞', '動詞']
科に入学	['名詞', '助詞', '名詞']
を出港し	['助詞', '名詞', '動詞']
の支配権	['助詞', '名詞', '名詞']
てしまっている	['助詞', '動詞', '助詞', '動詞']
本塁打を記録	['名詞', '助詞', '名詞']
が込められている	['助詞', '動詞', '動詞', '助詞', '動詞']
と発言し	['助詞', '名詞', '動詞']
学を学び	['名詞', '助詞', '動詞']
を探る	['助詞', '動詞']
に昇叙	['助詞', '名詞']
に赴く	['助詞', '動詞']
を発行する	['助詞', '名詞', '動詞']
メダルを獲得	['名詞', '助詞', '名詞']
を制圧し	['助詞', '名詞', '動詞']
父方の	['名詞', '助詞']
の面影	['助詞', '名詞']
が減っ	['助詞', '動詞']
幾度か	['名詞', '助詞']
独学で	['名詞', '助詞']
を使わず	['助詞', '動詞', '助動詞']
を併設し	['助詞', '名詞', '動詞']
へ戻り	['助詞', '動詞']
を放って	['助詞', '動詞', '助詞']
に認定され	['助詞', '名詞', '動詞', '動詞']
をクリアする	['助詞', '名詞', '動詞']
へ戻る	['助詞', '動詞']
を建てる	['助詞', '動詞']
を通す	['助詞', '動詞']
活動の場	['名詞', '助詞', '名詞']
を期待し	['助詞', '名詞', '動詞']
と定義し	['助詞', '名詞', '動詞']
作戦に参加	['名詞', '助詞', '名詞']
分の地点で	['名詞', '助詞', '名詞', '助詞']
を専攻し	['助詞', '名詞', '動詞']
墓地に埋葬された	['名詞', '助詞', '名詞', '動詞', '動詞', '助動詞']
大半は	['名詞', '助詞']
曲を収録	['名詞', '助詞', '名詞']
が採られ	['助詞', '動詞', '動詞']
家督を相続し	['名詞', '助詞', '名詞', '動詞']
を約束し	['助詞', '名詞', '動詞']
に生育する	['助詞', '名詞', '動詞']
いずれにせよ	['名詞', '助詞', '動詞']
ことが発覚	['名詞', '助詞', '名詞']
を動員し	['助詞', '名詞', '動詞']
を募集し	['助詞', '名詞', '動詞']
両者とも	['名詞', '助詞']
の分離集落	['助詞', '名詞', '名詞']
になれる	['助詞', '動詞']
を製作する	['助詞', '名詞', '動詞']
を高めるため	['助詞', '動詞', '名詞']
幾度も	['名詞', '助詞']
契約を結んで	['名詞', '助詞', '動詞', '助詞']
みどりの窓口	['名詞', '助詞', '名詞']
を患い	['助詞', '動詞']
を持ちかけ	['助詞', '動詞']
に関与する	['助詞', '名詞', '動詞']
に準拠し	['助詞', '名詞', '動詞']
を検討する	['助詞', '名詞', '動詞']
を掲載した	['助詞', '名詞', '動詞', '助動詞']
に従わ	['助詞', '動詞']
を意図し	['助詞', '名詞', '動詞']
家督を継いだ	['名詞', '助詞', '動詞', '助動詞']
に譲渡され	['助詞', '名詞', '動詞', '動詞']
巨額の	['名詞', '助詞']
も務めている	['助詞', '動詞', '助詞', '動詞']
を要し	['助詞', '動詞']
銀メダルを獲得	['名詞', '助詞', '名詞']
に改編され	['助詞', '名詞', '動詞', '動詞']
に苦しむ	['助詞', '動詞']
に到達し	['助詞', '名詞', '動詞']
のも特徴	['名詞', '助詞', '名詞']
年の国勢調査	['名詞', '助詞', '名詞']
と見なす	['助詞', '動詞']
をおこなっ	['助詞', '動詞']
作品に出演	['名詞', '助詞', '名詞']
の消息	['助詞', '名詞']
を確立する	['助詞', '名詞', '動詞']
を専門とする	['助詞', '名詞', '助詞', '動詞']
きょうかい	['名詞', '助詞']
を図って	['助詞', '動詞', '助詞']
を評価し	['助詞', '名詞', '動詞']
を欠く	['助詞', '動詞']
活動を展開	['名詞', '助詞', '名詞']
に登板して	['助詞', '名詞', '動詞', '助詞']
と思われていた	['助詞', '動詞', '動詞', '助詞', '動詞', '助動詞']
になぞらえ	['助詞', '動詞']
を譲り	['助詞', '動詞']
傷を負っ	['名詞', '助詞', '動詞']
ことは無かった	['名詞', '助詞', '形容詞', '助動詞']
に応える	['助詞', '動詞']
の隣に	['助詞', '名詞', '助詞']
に上った	['助詞', '動詞', '助動詞']
を依頼され	['助詞', '名詞', '動詞', '動詞']
に遭った	['助詞', '動詞', '助動詞']
ことが発表され	['名詞', '助詞', '名詞', '動詞', '動詞']
を結んでいた	['助詞', '動詞', '助詞', '動詞', '助動詞']
ことがわかった	['名詞', '助詞', '動詞', '助動詞']
各所に	['名詞', '助詞']
に長け	['助詞', '動詞']
が建っている	['助詞', '動詞', '助詞', '動詞']
と改められた	['助詞', '動詞', '動詞', '助動詞']
ことを目的に	['名詞', '助詞', '名詞', '助詞']
外に出	['名詞', '助詞', '動詞']
を好んだ	['助詞', '動詞', '助動詞']
を売る	['助詞', '動詞']
と思っている	['助詞', '動詞', '助詞', '動詞']
から外され	['助詞', '動詞', '動詞']
で破って	['助詞', '動詞', '助詞']
に収容され	['助詞', '名詞', '動詞', '動詞']
役を演じる	['名詞', '助詞', '動詞']
が試みられ	['助詞', '動詞', '動詞']
を原作とした	['助詞', '名詞', '助詞', '動詞', '助動詞']
部長に就任	['名詞', '助詞', '名詞']
を制限する	['助詞', '名詞', '動詞']
を表現した	['助詞', '名詞', '動詞', '助動詞']
に満たない	['助詞', '動詞', '助動詞']
を旅し	['助詞', '名詞', '動詞']
を前身とする	['助詞', '名詞', '助詞', '動詞']
に助けられ	['助詞', '動詞', '動詞']
に着く	['助詞', '動詞']
はあったものの	['助詞', '動詞', '助動詞', '助詞']
を牽引し	['助詞', '名詞', '動詞']
にスカウトされ	['助詞', '名詞', '動詞', '動詞']
と評し	['助詞', '動詞']
を報告した	['助詞', '名詞', '動詞', '助動詞']
を奪って	['助詞', '動詞', '助詞']
に沿う	['助詞', '動詞']
を採る	['助詞', '動詞']
に準ずる	['助詞', '動詞']
を許す	['助詞', '動詞']
に吸収合併され	['助詞', '名詞', '名詞', '動詞', '動詞']
を設定する	['助詞', '名詞', '動詞']
を置いていた	['助詞', '動詞', '助詞', '動詞', '助動詞']
も指摘されている	['助詞', '名詞', '動詞', '動詞', '助詞', '動詞']
ボタンを押す	['名詞', '助詞', '動詞']
で占められ	['助詞', '動詞', '動詞']
と区別するため	['助詞', '名詞', '動詞', '名詞']
ていくことになる	['助詞', '動詞', '名詞', '助詞', '動詞']
を積んで	['助詞', '動詞', '助詞']
説が有力	['名詞', '助詞', '名詞']
に分かれており	['助詞', '動詞', '助詞', '動詞']
を念頭に	['助詞', '名詞', '助詞']
を担っている	['助詞', '動詞', '助詞', '動詞']
ことが出来ず	['名詞', '助詞', '動詞', '助動詞']
わけではなかった	['名詞', '助詞', '助詞', '形容詞', '助動詞']
と接触し	['助詞', '名詞', '動詞']
を定義する	['助詞', '名詞', '動詞']
を優先し	['助詞', '名詞', '動詞']
に押され	['助詞', '動詞', '動詞']
を患って	['助詞', '動詞', '助詞']
を含めると	['助詞', '動詞', '助詞']
について記述する	['助詞', '名詞', '動詞']
ようになっており	['名詞', '助詞', '動詞', '助詞', '動詞']
を評価する	['助詞', '名詞', '動詞']
性に優れ	['名詞', '助詞', '動詞']
世紀に入って	['名詞', '助詞', '動詞', '助詞']
体調を崩し	['名詞', '助詞', '動詞']
に協力する	['助詞', '名詞', '動詞']
がかけられ	['助詞', '動詞', '動詞']
重傷を負った	['名詞', '助詞', '動詞', '助動詞']
を移す	['助詞', '動詞']
を産んだ	['助詞', '動詞', '助動詞']
に占領され	['助詞', '名詞', '動詞', '動詞']
として挙げられる	['助詞', '動詞', '動詞']
を低下させ	['助詞', '名詞', '動詞', '動詞']
を頼って	['助詞', '動詞', '助詞']
に違反し	['助詞', '名詞', '動詞']
と話した	['助詞', '動詞', '助動詞']
をコンセプトに	['助詞', '名詞', '助詞']
得点を決め	['名詞', '助詞', '動詞']
を喪失し	['助詞', '名詞', '動詞']
を排除する	['助詞', '名詞', '動詞']
に依頼し	['助詞', '名詞', '動詞']
と衝突し	['助詞', '名詞', '動詞']
城を攻め	['名詞', '助詞', '動詞']
に埋葬され	['助詞', '名詞', '動詞', '動詞']
を認識し	['助詞', '名詞', '動詞']
を再現した	['助詞', '名詞', '動詞', '助動詞']
条件を満たす	['名詞', '助詞', '動詞']
と認識され	['助詞', '名詞', '動詞', '動詞']
を横断する	['助詞', '名詞', '動詞']
を握って	['助詞', '動詞', '助詞']
を売却し	['助詞', '名詞', '動詞']
に比して	['助詞', '動詞', '助詞']
を夢見	['助詞', '名詞']
を行ってきた	['助詞', '動詞', '助詞', '動詞', '助動詞']
の後裔	['助詞', '名詞']
を従え	['助詞', '動詞']
活躍の場	['名詞', '助詞', '名詞']
を記念する	['助詞', '名詞', '動詞']
に投入され	['助詞', '名詞', '動詞', '動詞']
を証明し	['助詞', '名詞', '動詞']
を通した	['助詞', '動詞', '助動詞']
を反映した	['助詞', '名詞', '動詞', '助動詞']
を発生させ	['助詞', '名詞', '動詞', '動詞']
を踏んだ	['助詞', '動詞', '助動詞']
当選を果たした	['名詞', '助詞', '動詞', '助動詞']
も兼ねて	['助詞', '動詞', '助詞']
に宛てた	['助詞', '動詞', '助動詞']
を独占し	['助詞', '名詞', '動詞']
に引き取られ	['助詞', '動詞', '動詞']
を襲う	['助詞', '動詞']
ことを目的とした	['名詞', '助詞', '名詞', '助詞', '動詞', '助動詞']
の死去により	['助詞', '名詞', '助詞']
を望んでいた	['助詞', '動詞', '助詞', '動詞', '助動詞']
に占める	['助詞', '動詞']
反乱を起こし	['名詞', '助詞', '動詞']
が贈られた	['助詞', '動詞', '動詞', '助動詞']
に搭載し	['助詞', '名詞', '動詞']
を宣告され	['助詞', '名詞', '動詞', '動詞']
依頼を受け	['名詞', '助詞', '動詞']
を出発し	['助詞', '名詞', '動詞']
に譲り	['助詞', '動詞']
時間がかかる	['名詞', '助詞', '動詞']
に応募し	['助詞', '名詞', '動詞']
と答えている	['助詞', '動詞', '助詞', '動詞']
に傾倒し	['助詞', '名詞', '動詞']
ことを目的とする	['名詞', '助詞', '名詞', '助詞', '動詞']
を救った	['助詞', '動詞', '助動詞']
を稼ぐ	['助詞', '動詞']
難色を示	['名詞', '助詞', '名詞']
立て続けに	['名詞', '助詞']
登録を抹消	['名詞', '助詞', '名詞']
本塁打を放った	['名詞', '助詞', '動詞', '助動詞']
に因んで名付けられた	['助詞', '動詞', '助詞', '動詞', '動詞', '助動詞']
を突き止め	['助詞', '動詞']
を走行する	['助詞', '名詞', '動詞']
を陥落させ	['助詞', '名詞', '動詞', '動詞']
票を獲得し	['名詞', '助詞', '名詞', '動詞']
を担っていた	['助詞', '動詞', '助詞', '動詞', '助動詞']
に乗せて	['助詞', '動詞', '助詞']
を経る	['助詞', '動詞']
恋に落ち	['名詞', '助詞', '動詞']
に立たされ	['助詞', '動詞', '動詞']
を横断し	['助詞', '名詞', '動詞']
に立地する	['助詞', '名詞', '動詞']
高校に進学	['名詞', '助詞', '名詞']
を収集し	['助詞', '名詞', '動詞']
ことで知られている	['名詞', '助詞', '動詞', '動詞', '助詞', '動詞']
を明らかにする	['助詞', '名詞', '助詞', '動詞']
交通の要衝	['名詞', '助詞', '名詞']
ナイトを受賞した	['名詞', '助詞', '名詞', '動詞', '助動詞']
にとらわれ	['助詞', '動詞']
を着た	['助詞', '動詞', '助動詞']
と訳される	['助詞', '動詞', '動詞']
を作っている	['助詞', '動詞', '助詞', '動詞']
に居住する	['助詞', '名詞', '動詞']
のが始まりである	['名詞', '助詞', '動詞', '助動詞', '助動詞']
終戦を迎えた	['名詞', '助詞', '動詞', '助動詞']
に倣って	['助詞', '動詞', '助詞']
ことも多かった	['名詞', '助詞', '形容詞', '助動詞']
契約を解除	['名詞', '助詞', '名詞']
を譲る	['助詞', '動詞']
国の重要文化財	['名詞', '助詞', '名詞', '名詞']
攻撃を仕掛け	['名詞', '助詞', '名詞']
選挙に出馬し	['名詞', '助詞', '名詞', '動詞']
に区分され	['助詞', '名詞', '動詞', '動詞']
に更新され	['助詞', '名詞', '動詞', '動詞']
を登場させ	['助詞', '名詞', '動詞', '動詞']
を骨折し	['助詞', '名詞', '動詞']
を占拠し	['助詞', '名詞', '動詞']
と結論付け	['助詞', '名詞', '名詞']
を依頼し	['助詞', '名詞', '動詞']
を指摘する	['助詞', '名詞', '動詞']
と語っていた	['助詞', '動詞', '助詞', '動詞', '助動詞']
に限る	['助詞', '動詞']
ことは不可能	['名詞', '助詞', '名詞']
丘の上	['名詞', '助詞', '名詞']
脚光を浴び	['名詞', '助詞', '動詞']
生活を送った	['名詞', '助詞', '動詞', '助動詞']
状態に陥っ	['名詞', '助詞', '動詞']
グランプリを受賞	['名詞', '助詞', '名詞']
を公開した	['助詞', '名詞', '動詞', '助動詞']
を自称し	['助詞', '名詞', '動詞']
最良の	['名詞', '助詞']
に命じ	['助詞', '動詞']
に叙任され	['助詞', '名詞', '動詞', '動詞']
に加わって	['助詞', '動詞', '助詞']
を育成する	['助詞', '名詞', '動詞']
前述のとおり	['名詞', '助詞', '名詞']
の指定を受け	['助詞', '名詞', '助詞', '動詞']
が死ぬと	['助詞', '動詞', '助詞']
を奉じ	['助詞', '動詞']
へ移った	['助詞', '動詞', '助動詞']
を剥奪され	['助詞', '名詞', '動詞', '動詞']
を称する	['助詞', '動詞']
に寄与した	['助詞', '名詞', '動詞', '助動詞']
ことを目的としている	['名詞', '助詞', '名詞', '助詞', '動詞', '助詞', '動詞']
優勝を経験	['名詞', '助詞', '名詞']
を待たず	['助詞', '動詞', '助動詞']
を妨げる	['助詞', '動詞']
を命ぜられ	['助詞', '動詞', '動詞']
幕を閉じた	['名詞', '助詞', '動詞', '助動詞']
に上陸し	['助詞', '名詞', '動詞']
に欠ける	['助詞', '動詞']
ことが出来ない	['名詞', '助詞', '動詞', '助動詞']
格段に	['名詞', '助詞']
