トークン	品詞
のは	['名詞', '助詞']
がある	['助詞', '動詞']
になる	['助詞', '動詞']
のが	['名詞', '助詞']
ている	['助詞', '動詞']
ように	['名詞', '助詞']
のか	['名詞', '助詞']
と思います	['助詞', '動詞', '助動詞']
があります	['助詞', '動詞', '助動詞']
私は	['名詞', '助詞']
自分の	['名詞', '助詞']
的に	['名詞', '助詞']
これは	['名詞', '助詞']
にある	['助詞', '動詞']
ています	['助詞', '動詞', '助動詞']
になった	['助詞', '動詞', '助動詞']
ことを	['名詞', '助詞']
人の	['名詞', '助詞']
ことが	['名詞', '助詞']
さんの	['名詞', '助詞']
になります	['助詞', '動詞', '助動詞']
人が	['名詞', '助詞']
私の	['名詞', '助詞']
人は	['名詞', '助詞']
があり	['助詞', '動詞']
それは	['名詞', '助詞']
と思う	['助詞', '動詞']
というのは	['助詞', '名詞', '助詞']
のある	['助詞', '動詞']
ことは	['名詞', '助詞']
になって	['助詞', '動詞', '助詞']
となる	['助詞', '動詞']
前に	['名詞', '助詞']
他の	['名詞', '助詞']
のような	['助詞', '名詞', '助動詞']
にして	['助詞', '動詞', '助詞']
のように	['助詞', '名詞', '助詞']
のも	['名詞', '助詞']
の中で	['助詞', '名詞', '助詞']
をする	['助詞', '動詞']
日本の	['名詞', '助詞']
私が	['名詞', '助詞']
何か	['名詞', '助詞']
多くの	['名詞', '助詞']
を見る	['助詞', '動詞']
場合は	['名詞', '助詞']
ていた	['助詞', '動詞', '助動詞']
となります	['助詞', '動詞', '助動詞']
日に	['名詞', '助詞']
ということ	['助詞', '名詞']
もある	['助詞', '動詞']
があった	['助詞', '動詞', '助動詞']
を見	['助詞', '動詞']
さんが	['名詞', '助詞']
方は	['名詞', '助詞']
の方が	['助詞', '名詞', '助詞']
をして	['助詞', '動詞', '助詞']
それを	['名詞', '助詞']
になり	['助詞', '動詞']
年に	['名詞', '助詞']
のために	['助詞', '名詞', '助詞']
あなたの	['名詞', '助詞']
それが	['名詞', '助詞']
今回は	['名詞', '助詞']
っていた	['助詞', '動詞', '助動詞']
年の	['名詞', '助詞']
日の	['名詞', '助詞']
を使って	['助詞', '動詞', '助詞']
を見て	['助詞', '動詞', '助詞']
の場合	['助詞', '名詞']
中の	['名詞', '助詞']
ということで	['助詞', '名詞', '助動詞']
後に	['名詞', '助詞']
人気の	['名詞', '助詞']
簡単に	['名詞', '助詞']
私も	['名詞', '助詞']
方が	['名詞', '助詞']
今回の	['名詞', '助詞']
ために	['名詞', '助詞']
続きを読む	['名詞', '助詞', '動詞']
者の	['名詞', '助詞']
非常に	['名詞', '助詞']
かもしれません	['助詞', '動詞', '助動詞', '助動詞']
になりました	['助詞', '動詞', '助動詞', '助動詞']
のこと	['助詞', '名詞']
のため	['助詞', '名詞']
さんは	['名詞', '助詞']
上の	['名詞', '助詞']
と言う	['助詞', '動詞']
はこちら	['助詞', '名詞']
ができる	['助詞', '動詞']
時の	['名詞', '助詞']
人に	['名詞', '助詞']
になっている	['助詞', '動詞', '助詞', '動詞']
次の	['名詞', '助詞']
後の	['名詞', '助詞']
月の	['名詞', '助詞']
と思った	['助詞', '動詞', '助動詞']
等の	['名詞', '助詞']
今日は	['名詞', '助詞']
とした	['助詞', '動詞', '助動詞']
月に	['名詞', '助詞']
市の	['名詞', '助詞']
前の	['名詞', '助詞']
今の	['名詞', '助詞']
気になる	['名詞', '助詞', '動詞']
今まで	['名詞', '助詞']
を行う	['助詞', '動詞']
となった	['助詞', '動詞', '助動詞']
ときは	['名詞', '助詞']
自分が	['名詞', '助詞']
時は	['名詞', '助詞']
ときに	['名詞', '助詞']
これが	['名詞', '助詞']
と思って	['助詞', '動詞', '助詞']
とし	['助詞', '動詞']
以上の	['名詞', '助詞']
の方	['助詞', '名詞']
があって	['助詞', '動詞', '助詞']
自分で	['名詞', '助詞']
中に	['名詞', '助詞']
ことも	['名詞', '助詞']
もあります	['助詞', '動詞', '助動詞']
に行く	['助詞', '動詞']
のための	['助詞', '名詞', '助詞']
もあり	['助詞', '動詞']
とする	['助詞', '動詞']
を持つ	['助詞', '動詞']
ここで	['名詞', '助詞']
すべての	['名詞', '助詞']
はありません	['助詞', '動詞', '助動詞', '助動詞']
一緒に	['名詞', '助詞']
を持って	['助詞', '動詞', '助詞']
上で	['名詞', '助詞']
めて	['名詞', '助詞']
のバイト	['助詞', '名詞']
かもしれない	['助詞', '動詞', '助動詞']
気が	['名詞', '助詞']
ことができます	['名詞', '助詞', '動詞', '助動詞']
というのが	['助詞', '名詞', '助詞']
こちらの	['名詞', '助詞']
ものを	['名詞', '助詞']
家の	['名詞', '助詞']
の中に	['助詞', '名詞', '助詞']
を受け	['助詞', '動詞']
になると	['助詞', '動詞', '助詞']
目の	['名詞', '助詞']
をしている	['助詞', '動詞', '助詞', '動詞']
てきた	['助詞', '動詞', '助動詞']
今は	['名詞', '助詞']
の話	['助詞', '名詞']
の場合は	['助詞', '名詞', '助詞']
の派遣求人	['助詞', '名詞', '名詞']
用の	['名詞', '助詞']
というか	['助詞', '動詞', '助詞']
をした	['助詞', '動詞', '助動詞']
別の	['名詞', '助詞']
これで	['名詞', '助詞']
これを	['名詞', '助詞']
情報を	['名詞', '助詞']
があれば	['助詞', '動詞', '助詞']
かもしれませんが	['助詞', '動詞', '助動詞', '助動詞', '助詞']
内の	['名詞', '助詞']
てしまう	['助詞', '動詞']
町の	['名詞', '助詞']
にする	['助詞', '動詞']
の口コミ	['助詞', '名詞']
にした	['助詞', '動詞', '助動詞']
を探す	['助詞', '動詞']
中で	['名詞', '助詞']
人と	['名詞', '助詞']
に行って	['助詞', '動詞', '助詞']
国の	['名詞', '助詞']
者が	['名詞', '助詞']
はある	['助詞', '動詞']
ものは	['名詞', '助詞']
あなたが	['名詞', '助詞']
ッと	['名詞', '助詞']
今日の	['名詞', '助詞']
人も	['名詞', '助詞']
の上	['助詞', '名詞']
確かに	['名詞', '助詞']
を含む	['助詞', '動詞']
女性の	['名詞', '助詞']
商品の	['名詞', '助詞']
の日	['助詞', '名詞']
気に	['名詞', '助詞']
最後の	['名詞', '助詞']
があるので	['助詞', '動詞', '助詞']
これまで	['名詞', '助詞']
先に	['名詞', '助詞']
が必要	['助詞', '名詞']
これらの	['名詞', '助詞']
何も	['名詞', '助詞']
ていく	['助詞', '動詞']
のもの	['助詞', '名詞']
ものが	['名詞', '助詞']
と言って	['助詞', '動詞', '助詞']
さんに	['名詞', '助詞']
方に	['名詞', '助詞']
を作る	['助詞', '動詞']
以下の	['名詞', '助詞']
ことができる	['名詞', '助詞', '動詞']
あなたは	['名詞', '助詞']
となって	['助詞', '動詞', '助詞']
の問題	['助詞', '名詞']
がありました	['助詞', '動詞', '助動詞', '助動詞']
と思っています	['助詞', '動詞', '助詞', '動詞', '助動詞']
事を	['名詞', '助詞']
駅の	['名詞', '助詞']
以外の	['名詞', '助詞']
目に	['名詞', '助詞']
の方は	['助詞', '名詞', '助詞']
ております	['助詞', '動詞', '助動詞']
その他の	['名詞', '助詞']
を確認	['助詞', '名詞']
事が	['名詞', '助詞']
僕は	['名詞', '助詞']
流程	['名詞', '助詞']
逆に	['名詞', '助詞']
時間が	['名詞', '助詞']
内で	['名詞', '助詞']
者は	['名詞', '助詞']
会社の	['名詞', '助詞']
ってしまう	['助詞', '動詞']
になっています	['助詞', '動詞', '助詞', '動詞', '助動詞']
現在の	['名詞', '助詞']
後は	['名詞', '助詞']
ための	['名詞', '助詞']
の中	['助詞', '名詞']
色の	['名詞', '助詞']
を使う	['助詞', '動詞']
というもの	['助詞', '名詞']
系の	['名詞', '助詞']
の記事	['助詞', '名詞']
を選ぶ	['助詞', '動詞']
時間を	['名詞', '助詞']
と一緒に	['助詞', '名詞', '助詞']
が出	['助詞', '動詞']
の人	['助詞', '名詞']
間に	['名詞', '助詞']
ごとに	['名詞', '助詞']
に出	['助詞', '動詞']
さが	['名詞', '助詞']
の大	['助詞', '名詞']
んでいる	['助詞', '動詞']
のかな	['名詞', '助詞', '助詞']
の一	['助詞', '名詞']
んこ	['助詞', '名詞']
場合がございます	['名詞', '助詞', '動詞', '助動詞']
につきましては	['助詞', '動詞', '助動詞', '助詞', '助詞']
さんと	['名詞', '助詞']
と思い	['助詞', '動詞']
をはじめ	['助詞', '名詞']
といえば	['助詞', '動詞', '助詞']
ってきた	['助詞', '動詞', '助動詞']
場合には	['名詞', '助詞', '助詞']
日は	['名詞', '助詞']
うちに	['名詞', '助詞']
おすすめの	['名詞', '助詞']
がいる	['助詞', '動詞']
の商品	['助詞', '名詞']
無料で	['名詞', '助詞']
最後に	['名詞', '助詞']
を使った	['助詞', '動詞', '助動詞']
のホテル	['助詞', '名詞']
ており	['助詞', '動詞']
完全に	['名詞', '助詞']
人で	['名詞', '助詞']
と思いますが	['助詞', '動詞', '助動詞', '助詞']
それぞれの	['名詞', '助詞']
ということは	['助詞', '名詞', '助詞']
普通の	['名詞', '助詞']
の違い	['助詞', '名詞']
内に	['名詞', '助詞']
を取り	['助詞', '動詞']
たくさんの	['名詞', '助詞']
車の	['名詞', '助詞']
最初の	['名詞', '助詞']
市で	['名詞', '助詞']
は何	['助詞', '名詞']
をし	['助詞', '動詞']
人を	['名詞', '助詞']
最近は	['名詞', '助詞']
のを	['名詞', '助詞']
的には	['名詞', '助詞', '助詞']
に行った	['助詞', '動詞', '助動詞']
上に	['名詞', '助詞']
と思いました	['助詞', '動詞', '助動詞', '助動詞']
ここまで	['名詞', '助詞']
日から	['名詞', '助詞']
複数の	['名詞', '助詞']
ことがあります	['名詞', '助詞', '動詞', '助動詞']
を中心に	['助詞', '名詞', '助詞']
ここに	['名詞', '助詞']
に参加	['助詞', '名詞']
がありますが	['助詞', '動詞', '助動詞', '助詞']
彼の	['名詞', '助詞']
方の	['名詞', '助詞']
てしまった	['助詞', '動詞', '助動詞']
が出る	['助詞', '動詞']
側の	['名詞', '助詞']
ていました	['助詞', '動詞', '助動詞', '助動詞']
てくれる	['助詞', '動詞']
いの	['名詞', '助詞']
彼は	['名詞', '助詞']
の仕事	['助詞', '名詞']
を作って	['助詞', '動詞', '助詞']
力を	['名詞', '助詞']
商品は	['名詞', '助詞']
明らかに	['名詞', '助詞']
タイプの	['名詞', '助詞']
ていて	['助詞', '動詞', '助詞']
そこに	['名詞', '助詞']
仕事を	['名詞', '助詞']
下の	['名詞', '助詞']
に対応	['助詞', '名詞']
を受ける	['助詞', '動詞']
手の	['名詞', '助詞']
お金を	['名詞', '助詞']
主に	['名詞', '助詞']
のほうが	['助詞', '名詞', '助詞']
の世界	['助詞', '名詞']
うちの	['名詞', '助詞']
も多く	['助詞', '名詞']
となっている	['助詞', '動詞', '助詞', '動詞']
前から	['名詞', '助詞']
世界の	['名詞', '助詞']
ようと	['名詞', '助詞']
となっています	['助詞', '動詞', '助詞', '動詞', '助動詞']
が出て	['助詞', '動詞', '助詞']
の関係	['助詞', '名詞']
もあった	['助詞', '動詞', '助動詞']
手に	['名詞', '助詞']
の写真	['助詞', '名詞']
ネットで	['名詞', '助詞']
の一つ	['助詞', '名詞']
を持ち	['助詞', '動詞']
に入って	['助詞', '動詞', '助詞']
全ての	['名詞', '助詞']
目を	['名詞', '助詞']
様に	['名詞', '助詞']
これも	['名詞', '助詞']
を受けた	['助詞', '動詞', '助動詞']
にならない	['助詞', '動詞', '助動詞']
のうち	['助詞', '名詞']
話を	['名詞', '助詞']
こちらは	['名詞', '助詞']
の一部	['助詞', '名詞']
に向けて	['助詞', '動詞', '助詞']
さを	['名詞', '助詞']
たちの	['名詞', '助詞']
っていました	['助詞', '動詞', '助動詞', '助動詞']
に合わせて	['助詞', '動詞', '助詞']
僕の	['名詞', '助詞']
の情報	['助詞', '名詞']
のほう	['助詞', '名詞']
ということです	['助詞', '名詞', '助動詞']
ことから	['名詞', '助詞']
を採用	['助詞', '名詞']
を選択	['助詞', '名詞']
ようになりました	['名詞', '助詞', '動詞', '助動詞', '助動詞']
子の	['名詞', '助詞']
が可能	['助詞', '名詞']
女性が	['名詞', '助詞']
の人気	['助詞', '名詞']
あとは	['名詞', '助詞']
何を	['名詞', '助詞']
てください	['助詞', '動詞']
状態で	['名詞', '助詞']
時点で	['名詞', '助詞']
今年は	['名詞', '助詞']
っております	['助詞', '動詞', '助動詞']
普通に	['名詞', '助詞']
によると	['助詞', '動詞', '助詞']
ちゃんの	['名詞', '助詞']
を感じ	['助詞', '動詞']
以上に	['名詞', '助詞']
確実に	['名詞', '助詞']
間の	['名詞', '助詞']
相手の	['名詞', '助詞']
大な	['名詞', '助詞']
目が	['名詞', '助詞']
を見た	['助詞', '動詞', '助動詞']
っていない	['助詞', '動詞', '助動詞']
のことを	['助詞', '名詞', '助詞']
方も	['名詞', '助詞']
みたいに	['名詞', '助詞']
の間	['助詞', '名詞']
たちが	['名詞', '助詞']
のまま	['助詞', '名詞']
いつでも	['名詞', '助詞', '助詞']
スの	['名詞', '助詞']
を購入	['助詞', '名詞']
心の	['名詞', '助詞']
がありません	['助詞', '動詞', '助動詞', '助動詞']
自分に	['名詞', '助詞']
と思っている	['助詞', '動詞', '助詞', '動詞']
感が	['名詞', '助詞']
物の	['名詞', '助詞']
商品を	['名詞', '助詞']
を与え	['助詞', '動詞']
となりました	['助詞', '動詞', '助動詞', '助動詞']
部の	['名詞', '助詞']
今日も	['名詞', '助詞']
があると	['助詞', '動詞', '助詞']
を実施	['助詞', '名詞']
相手に	['名詞', '助詞']
に来て	['助詞', '動詞', '助詞']
性を	['名詞', '助詞']
の特徴	['助詞', '名詞']
町で	['名詞', '助詞']
手を	['名詞', '助詞']
といっても	['助詞', '動詞', '助詞', '助詞']
物を	['名詞', '助詞']
お客様の	['名詞', '助詞']
最初に	['名詞', '助詞']
夏の	['名詞', '助詞']
側に	['名詞', '助詞']
種類の	['名詞', '助詞']
歳の	['名詞', '助詞']
わけで	['名詞', '助詞']
の中でも	['助詞', '名詞', '助詞', '助詞']
を持っている	['助詞', '動詞', '助詞', '動詞']
の新	['助詞', '名詞']
誰か	['名詞', '助詞']
女性は	['名詞', '助詞']
最近の	['名詞', '助詞']
と呼ばれる	['助詞', '動詞', '動詞']
ってくる	['助詞', '動詞']
が見	['助詞', '動詞']
最高の	['名詞', '助詞']
数は	['名詞', '助詞']
めの	['名詞', '助詞']
事は	['名詞', '助詞']
を感じる	['助詞', '動詞']
大人の	['名詞', '助詞']
効果が	['名詞', '助詞']
ためには	['名詞', '助詞', '助詞']
他にも	['名詞', '助詞', '助詞']
っていて	['助詞', '動詞', '助詞']
の種類	['助詞', '名詞']
が違う	['助詞', '動詞']
にいる	['助詞', '動詞']
氏は	['名詞', '助詞']
ところに	['名詞', '助詞']
を受けて	['助詞', '動詞', '助詞']
の手	['助詞', '名詞']
の内容	['助詞', '名詞']
先の	['名詞', '助詞']
の中から	['助詞', '名詞', '助詞']
を探	['助詞', '動詞']
こともあります	['名詞', '助詞', '動詞', '助動詞']
の流れ	['助詞', '名詞']
ことがある	['名詞', '助詞', '動詞']
体の	['名詞', '助詞']
わけではない	['名詞', '助詞', '助詞', '形容詞']
自分は	['名詞', '助詞']
の本	['助詞', '名詞']
の花	['助詞', '名詞']
をもって	['助詞', '動詞', '助詞']
サイトの	['名詞', '助詞']
にし	['助詞', '動詞']
にあります	['助詞', '動詞', '助動詞']
の街コン	['助詞', '名詞', '名詞']
今年の	['名詞', '助詞']
こともある	['名詞', '助詞', '動詞']
家に	['名詞', '助詞']
がございます	['助詞', '動詞', '助動詞']
力が	['名詞', '助詞']
時間は	['名詞', '助詞']
方法は	['名詞', '助詞']
が必要です	['助詞', '名詞', '助動詞']
今後の	['名詞', '助詞']
子供の	['名詞', '助詞']
車で	['名詞', '助詞']
を実現	['助詞', '名詞']
場合があります	['名詞', '助詞', '動詞', '助動詞']
初の	['名詞', '助詞']
たちは	['名詞', '助詞']
を紹介	['助詞', '名詞']
絶対に	['名詞', '助詞']
の間に	['助詞', '名詞', '助詞']
ここでは	['名詞', '助詞', '助詞']
そこまで	['名詞', '助詞']
時代の	['名詞', '助詞']
の原因	['助詞', '名詞']
てくる	['助詞', '動詞']
を行い	['助詞', '動詞']
の数	['助詞', '名詞']
になってしまう	['助詞', '動詞', '助詞', '動詞']
にこ	['助詞', '動詞']
駅から	['名詞', '助詞']
近くの	['名詞', '助詞']
の結果	['助詞', '名詞']
氏の	['名詞', '助詞']
丁寧に	['名詞', '助詞']
を作り	['助詞', '動詞']
を表示	['助詞', '名詞']
ができます	['助詞', '動詞', '助動詞']
の声	['助詞', '名詞']
もありますが	['助詞', '動詞', '助動詞', '助詞']
にあった	['助詞', '動詞', '助動詞']
てしまいます	['助詞', '動詞', '助動詞']
あなたに	['名詞', '助詞']
名の	['名詞', '助詞']
と思ったら	['助詞', '動詞', '助動詞']
という事	['助詞', '名詞']
の状態	['助詞', '名詞']
の評価	['助詞', '名詞']
過去の	['名詞', '助詞']
最初は	['名詞', '助詞']
さんも	['名詞', '助詞']
の歴史	['助詞', '名詞']
とのこと	['名詞', '助詞']
を取	['助詞', '動詞']
代の	['名詞', '助詞']
の方に	['助詞', '名詞', '助詞']
に入る	['助詞', '動詞']
企業の	['名詞', '助詞']
性の	['名詞', '助詞']
を見ると	['助詞', '動詞', '助詞']
どこか	['名詞', '助詞']
の利用	['助詞', '名詞']
の名前	['助詞', '名詞']
を出す	['助詞', '動詞']
型の	['名詞', '助詞']
に見	['助詞', '動詞']
女性に	['名詞', '助詞']
最大の	['名詞', '助詞']
当時の	['名詞', '助詞']
ンの	['名詞', '助詞']
を求める	['助詞', '動詞']
僕が	['名詞', '助詞']
地域の	['名詞', '助詞']
すと	['名詞', '助詞']
形で	['名詞', '助詞']
の意味	['助詞', '名詞']
の色	['助詞', '名詞']
にしても	['助詞', '動詞', '助詞', '助詞']
もあるので	['助詞', '動詞', '助詞']
価格で	['名詞', '助詞']
勝手に	['名詞', '助詞']
月から	['名詞', '助詞']
に入り	['助詞', '動詞']
者に	['名詞', '助詞']
それも	['名詞', '助詞']
の時	['助詞', '名詞']
を出	['助詞', '動詞']
が入って	['助詞', '動詞', '助詞']
の後	['助詞', '名詞']
時間の	['名詞', '助詞']
というと	['助詞', '動詞', '助詞']
人には	['名詞', '助詞', '助詞']
のと	['名詞', '助詞']
店の	['名詞', '助詞']
急に	['名詞', '助詞']
車を	['名詞', '助詞']
意味で	['名詞', '助詞']
身に	['名詞', '助詞']
をチェック	['助詞', '名詞']
の影響	['助詞', '名詞']
人間の	['名詞', '助詞']
てきました	['助詞', '動詞', '助動詞', '助動詞']
を読む	['助詞', '動詞']
の中には	['助詞', '名詞', '助詞', '助詞']
のところ	['助詞', '名詞']
ということを	['助詞', '名詞', '助詞']
と言われる	['助詞', '動詞', '動詞']
の通販	['助詞', '名詞']
を利用して	['助詞', '名詞', '動詞', '助詞']
程度の	['名詞', '助詞']
業者の	['名詞', '助詞']
気がする	['名詞', '助詞', '動詞']
を開始	['助詞', '名詞']
気軽に	['名詞', '助詞']
時から	['名詞', '助詞']
顔を	['名詞', '助詞']
になること	['助詞', '動詞', '名詞']
の実	['助詞', '名詞']
のかもしれません	['名詞', '助詞', '動詞', '助動詞', '助動詞']
もあって	['助詞', '動詞', '助詞']
とその	['名詞', '助詞']
の効果	['助詞', '名詞']
会の	['名詞', '助詞']
ができ	['助詞', '動詞']
さに	['名詞', '助詞']
を使い	['助詞', '動詞']
の求人	['助詞', '名詞']
社の	['名詞', '助詞']
を使用	['助詞', '名詞']
を超える	['助詞', '動詞']
男の	['名詞', '助詞']
を使用して	['助詞', '名詞', '動詞', '助詞']
を買う	['助詞', '動詞']
の名	['助詞', '名詞']
を行って	['助詞', '動詞', '助詞']
ここは	['名詞', '助詞']
を入れて	['助詞', '動詞', '助詞']
肌に	['名詞', '助詞']
事前に	['名詞', '助詞']
情報が	['名詞', '助詞']
の為	['助詞', '名詞']
場の	['名詞', '助詞']
肌の	['名詞', '助詞']
数が	['名詞', '助詞']
今度は	['名詞', '助詞']
を目指す	['助詞', '動詞']
位の	['名詞', '助詞']
理由は	['名詞', '助詞']
子が	['名詞', '助詞']
と言われ	['助詞', '動詞', '動詞']
サイトで	['名詞', '助詞']
を利用する	['助詞', '名詞', '動詞']
の下	['助詞', '名詞']
彼女の	['名詞', '助詞']
の魅力	['助詞', '名詞']
数の	['名詞', '助詞']
日本で	['名詞', '助詞']
名無しにかわりまして	['名詞', '助詞', '動詞', '助動詞', '助詞']
道を	['名詞', '助詞']
の販売	['助詞', '名詞']
に着	['助詞', '動詞']
件の口コミ	['名詞', '助詞', '名詞']
どこに	['名詞', '助詞']
そこから	['名詞', '助詞']
家で	['名詞', '助詞']
に必要な	['助詞', '名詞', '助動詞']
周辺の	['名詞', '助詞']
何が	['名詞', '助詞']
昔の	['名詞', '助詞']
が好きな	['助詞', '名詞', '助動詞']
と思っていた	['助詞', '動詞', '助詞', '動詞', '助動詞']
独自の	['名詞', '助詞']
と思われる	['助詞', '動詞', '動詞']
俺は	['名詞', '助詞']
の女性	['助詞', '名詞']
現在は	['名詞', '助詞']
これだけ	['名詞', '助詞']
心を	['名詞', '助詞']
円で	['名詞', '助詞']
ようになった	['名詞', '助詞', '動詞', '助動詞']
の中古車	['助詞', '名詞', '名詞']
となると	['助詞', '動詞', '助詞']
誰でも	['名詞', '助詞', '助詞']
を提供	['助詞', '名詞']
無料の	['名詞', '助詞']
向けの	['名詞', '助詞']
気がします	['名詞', '助詞', '動詞', '助動詞']
誰も	['名詞', '助詞']
日本は	['名詞', '助詞']
が出来る	['助詞', '動詞']
様の	['名詞', '助詞']
アメリカの	['名詞', '助詞']
今年も	['名詞', '助詞']
気を	['名詞', '助詞']
の前に	['助詞', '名詞', '助詞']
際に	['名詞', '助詞']
の時間	['助詞', '名詞']
体を	['名詞', '助詞']
点は	['名詞', '助詞']
いくつか	['名詞', '助詞']
必要があります	['名詞', '助詞', '動詞', '助動詞']
近くに	['名詞', '助詞']
を考え	['助詞', '動詞']
新たに	['名詞', '助詞']
の子	['助詞', '名詞']
家を	['名詞', '助詞']
の家	['助詞', '名詞']
性が	['名詞', '助詞']
てしまい	['助詞', '動詞']
を行った	['助詞', '動詞', '助動詞']
日まで	['名詞', '助詞']
のひとつ	['助詞', '名詞']
女の	['名詞', '助詞']
の上に	['助詞', '名詞', '助詞']
業者に	['名詞', '助詞']
ってこと	['助詞', '名詞']
の通り	['助詞', '名詞']
道の	['名詞', '助詞']
を知る	['助詞', '動詞']
商品が	['名詞', '助詞']
全体の	['名詞', '助詞']
氏が	['名詞', '助詞']
風に	['名詞', '助詞']
がかかる	['助詞', '動詞']
用に	['名詞', '助詞']
を引き	['助詞', '動詞']
の購入	['助詞', '名詞']
音が	['名詞', '助詞']
を楽しむ	['助詞', '動詞']
のブログ	['助詞', '名詞']
は非常に	['助詞', '名詞', '助詞']
の様子	['助詞', '名詞']
次は	['名詞', '助詞']
線の	['名詞', '助詞']
事で	['名詞', '助詞']
先生の	['名詞', '助詞']
場合に	['名詞', '助詞']
って感じ	['助詞', '名詞']
会社に	['名詞', '助詞']
が必要な	['助詞', '名詞', '助動詞']
という言葉	['助詞', '名詞']
を買って	['助詞', '動詞', '助詞']
目で	['名詞', '助詞']
の設定	['助詞', '名詞']
種の	['名詞', '助詞']
を開催	['助詞', '名詞']
山の	['名詞', '助詞']
を見つけ	['助詞', '動詞']
自分を	['名詞', '助詞']
の相場	['助詞', '名詞']
としている	['助詞', '動詞', '助詞', '動詞']
特定の	['名詞', '助詞']
今から	['名詞', '助詞']
ってきて	['助詞', '動詞', '助詞']
所に	['名詞', '助詞']
と思うんです	['助詞', '動詞', '名詞', '助動詞']
お客様に	['名詞', '助詞']
一つの	['名詞', '助詞']
に乗って	['助詞', '動詞', '助詞']
をご覧ください	['助詞', '名詞', '動詞']
最新の	['名詞', '助詞']
と言えば	['助詞', '動詞', '助詞']
の事	['助詞', '名詞']
本の	['名詞', '助詞']
に入った	['助詞', '動詞', '助動詞']
めに	['名詞', '助詞']
ところは	['名詞', '助詞']
に応じて	['助詞', '動詞', '助詞']
彼女は	['名詞', '助詞']
中には	['名詞', '助詞', '助詞']
を除く	['助詞', '動詞']
自身の	['名詞', '助詞']
を食べ	['助詞', '動詞']
写真は	['名詞', '助詞']
人もいる	['名詞', '助詞', '動詞']
以外に	['名詞', '助詞']
の裏	['助詞', '名詞']
もありません	['助詞', '動詞', '助動詞', '助動詞']
と思うのですが	['助詞', '動詞', '名詞', '助動詞', '助詞']
を検討	['助詞', '名詞']
のもと	['助詞', '名詞']
本当の	['名詞', '助詞']
を進め	['助詞', '動詞']
の国	['助詞', '名詞']
手で	['名詞', '助詞']
を考える	['助詞', '動詞']
感じで	['名詞', '助詞']
を取得	['助詞', '名詞']
最後まで	['名詞', '助詞']
問題は	['名詞', '助詞']
情報の	['名詞', '助詞']
の水	['助詞', '名詞']
方法を	['名詞', '助詞']
全国の	['名詞', '助詞']
さんから	['名詞', '助詞']
の皆さん	['助詞', '名詞']
夜の	['名詞', '助詞']
価格は	['名詞', '助詞']
をかけ	['助詞', '動詞']
効果は	['名詞', '助詞']
昨日の	['名詞', '助詞']
たびに	['名詞', '助詞']
てくれた	['助詞', '動詞', '助動詞']
を示す	['助詞', '動詞']
自由に	['名詞', '助詞']
に比べて	['助詞', '動詞', '助詞']
久しぶりに	['名詞', '助詞']
子は	['名詞', '助詞']
内容は	['名詞', '助詞']
場所に	['名詞', '助詞']
一部の	['名詞', '助詞']
地の	['名詞', '助詞']
の使用	['助詞', '名詞']
というふうに	['助詞', '名詞', '助詞']
時代に	['名詞', '助詞']
手が	['名詞', '助詞']
に入れて	['助詞', '動詞', '助詞']
の内	['助詞', '名詞']
を残	['助詞', '名詞']
せいか	['名詞', '助詞']
方を	['名詞', '助詞']
の中の	['助詞', '名詞', '助詞']
どれだけ	['名詞', '助詞']
島の	['名詞', '助詞']
をやって	['助詞', '動詞', '助詞']
ちゃんが	['名詞', '助詞']
を入れ	['助詞', '動詞']
ことはありません	['名詞', '助詞', '動詞', '助動詞', '助動詞']
の方法	['助詞', '名詞']
目は	['名詞', '助詞']
に取り	['助詞', '動詞']
通常の	['名詞', '助詞']
があるの	['助詞', '動詞', '助詞']
色が	['名詞', '助詞']
みんなの	['名詞', '助詞']
男性が	['名詞', '助詞']
為に	['名詞', '助詞']
にかかる	['助詞', '動詞']
等を	['名詞', '助詞']
昔から	['名詞', '助詞']
仕事が	['名詞', '助詞']
年から	['名詞', '助詞']
をクリック	['助詞', '名詞']
を起こ	['助詞', '動詞']
と言っても	['助詞', '動詞', '助詞', '助詞']
長の	['名詞', '助詞']
の出	['助詞', '名詞']
場で	['名詞', '助詞']
を通	['助詞', '名詞']
大学の	['名詞', '助詞']
昨日は	['名詞', '助詞']
ができない	['助詞', '動詞', '助動詞']
をしていた	['助詞', '動詞', '助詞', '動詞', '助動詞']
と言い	['助詞', '動詞']
を迎え	['助詞', '動詞']
の詳細	['助詞', '名詞']
となっております	['助詞', '動詞', '助詞', '動詞', '助動詞']
話が	['名詞', '助詞']
を読んで	['助詞', '動詞', '助詞']
の平均	['助詞', '名詞']
に入れ	['助詞', '動詞']
の存在	['助詞', '名詞']
味が	['名詞', '助詞']
代わりに	['名詞', '助詞']
ものと	['名詞', '助詞']
を持った	['助詞', '動詞', '助動詞']
ことはない	['名詞', '助詞', '形容詞']
の準備	['助詞', '名詞']
心に	['名詞', '助詞']
を出して	['助詞', '動詞', '助詞']
はどこ	['助詞', '名詞']
というような	['助詞', '名詞', '助動詞']
に通	['助詞', '名詞']
なんでも	['名詞', '助詞', '助詞']
の価格	['助詞', '名詞']
ここから	['名詞', '助詞']
が可能です	['助詞', '名詞', '助動詞']
業者が	['名詞', '助詞']
店で	['名詞', '助詞']
に移	['助詞', '名詞']
の説明	['助詞', '名詞']
内容を	['名詞', '助詞']
な感じ	['助詞', '名詞']
に係る	['助詞', '動詞']
の動き	['助詞', '名詞']
のコメント	['助詞', '名詞']
件の	['名詞', '助詞']
をしたい	['助詞', '動詞', '助動詞']
の変化	['助詞', '名詞']
必要がある	['名詞', '助詞', '動詞']
ってくれ	['助詞', '動詞']
男性の	['名詞', '助詞']
それまで	['名詞', '助詞']
相手が	['名詞', '助詞']
ままに	['名詞', '助詞']
を始め	['助詞', '名詞']
らか	['名詞', '助詞']
日が	['名詞', '助詞']
かなりの	['名詞', '助詞']
がついて	['助詞', '動詞', '助詞']
の作品	['助詞', '名詞']
の前	['助詞', '名詞']
中は	['名詞', '助詞']
を売る	['助詞', '動詞']
たいと思います	['名詞', '助詞', '動詞', '助動詞']
をかけて	['助詞', '動詞', '助詞']
こちらも	['名詞', '助詞']
日本に	['名詞', '助詞']
方法で	['名詞', '助詞']
何でも	['名詞', '助詞', '助詞']
子どもの	['名詞', '助詞']
日本では	['名詞', '助詞', '助詞']
に頼	['助詞', '名詞']
を取る	['助詞', '動詞']
の方も	['助詞', '名詞', '助詞']
という話	['助詞', '名詞']
ているので	['助詞', '動詞', '助詞']
を得る	['助詞', '動詞']
時まで	['名詞', '助詞']
ンと	['名詞', '助詞']
ということが	['助詞', '名詞', '助詞']
製の	['名詞', '助詞']
金の	['名詞', '助詞']
を比較	['助詞', '名詞']
円の	['名詞', '助詞']
みんなで	['名詞', '助詞']
を開け	['助詞', '動詞']
の時に	['助詞', '名詞', '助詞']
地元の	['名詞', '助詞']
に加え	['助詞', '動詞']
という点	['助詞', '名詞']
の人が	['助詞', '名詞', '助詞']
仕事の	['名詞', '助詞']
頭に	['名詞', '助詞']
てしまいました	['助詞', '動詞', '助動詞', '助動詞']
を選んで	['助詞', '動詞', '助詞']
に従	['助詞', '名詞']
といい	['助詞', '動詞']
情報は	['名詞', '助詞']
を見つける	['助詞', '動詞']
サイトを	['名詞', '助詞']
頃から	['名詞', '助詞']
上記の	['名詞', '助詞']
彼らは	['名詞', '助詞']
を追加	['助詞', '名詞']
を見せ	['助詞', '動詞']
の紹介	['助詞', '名詞']
になるので	['助詞', '動詞', '助詞']
んの	['名詞', '助詞']
ことが多い	['名詞', '助詞', '形容詞']
風の	['名詞', '助詞']
部屋の	['名詞', '助詞']
私には	['名詞', '助詞', '助詞']
俺の	['名詞', '助詞']
ほうがいい	['名詞', '助詞', '形容詞']
の中では	['助詞', '名詞', '助詞', '助詞']
言葉を	['名詞', '助詞']
になったら	['助詞', '動詞', '助動詞']
を発表	['助詞', '名詞']
回の	['名詞', '助詞']
ものに	['名詞', '助詞']
子供が	['名詞', '助詞']
体が	['名詞', '助詞']
期の	['名詞', '助詞']
を行います	['助詞', '動詞', '助動詞']
力の	['名詞', '助詞']
らの	['名詞', '助詞']
ルの	['名詞', '助詞']
ちゃんは	['名詞', '助詞']
他に	['名詞', '助詞']
を設定	['助詞', '名詞']
てくれ	['助詞', '動詞']
の開発	['助詞', '名詞']
お金が	['名詞', '助詞']
場所で	['名詞', '助詞']
口コミは	['名詞', '助詞']
と考える	['助詞', '動詞']
父の	['名詞', '助詞']
を失	['助詞', '名詞']
途中で	['名詞', '助詞']
に向かって	['助詞', '動詞', '助詞']
を集め	['助詞', '動詞']
条の	['名詞', '助詞']
の木	['助詞', '名詞']
を使用した	['助詞', '名詞', '動詞', '助動詞']
と考えています	['助詞', '動詞', '助詞', '動詞', '助動詞']
の経験	['助詞', '名詞']
今後も	['名詞', '助詞']
のおすすめ	['助詞', '名詞']
を与える	['助詞', '動詞']
を書く	['助詞', '動詞']
を作成	['助詞', '名詞']
わけではありません	['名詞', '助詞', '助詞', '動詞', '助動詞', '助動詞']
活動を	['名詞', '助詞']
日で	['名詞', '助詞']
生の	['名詞', '助詞']
は大	['助詞', '名詞']
残念ながら	['名詞', '助詞']
最初から	['名詞', '助詞']
頃は	['名詞', '助詞']
十分に	['名詞', '助詞']
中国の	['名詞', '助詞']
者を	['名詞', '助詞']
所で	['名詞', '助詞']
っており	['助詞', '名詞']
方には	['名詞', '助詞', '助詞']
に行き	['助詞', '動詞']
にあり	['助詞', '動詞']
のデザイン	['助詞', '名詞']
気をつけ	['名詞', '助詞', '名詞']
いくつかの	['名詞', '助詞', '助詞']
の際に	['助詞', '名詞', '助詞']
を守る	['助詞', '動詞']
事も	['名詞', '助詞']
製品の	['名詞', '助詞']
に変更	['助詞', '名詞']
があること	['助詞', '動詞', '名詞']
場合の	['名詞', '助詞']
今では	['名詞', '助詞', '助詞']
詳細は	['名詞', '助詞']
が行われ	['助詞', '動詞', '動詞']
を用意	['助詞', '名詞']
を書いて	['助詞', '動詞', '助詞']
コメントを	['名詞', '助詞']
たこと	['名詞', '助詞']
話題の	['名詞', '助詞']
のア	['助詞', '名詞']
感じが	['名詞', '助詞']
と思われます	['助詞', '動詞', '動詞', '助動詞']
になっていた	['助詞', '動詞', '助詞', '動詞', '助動詞']
効果を	['名詞', '助詞']
法の	['名詞', '助詞']
の言葉	['助詞', '名詞']
ブランドの	['名詞', '助詞']
の状況	['助詞', '名詞']
物が	['名詞', '助詞']
問題を	['名詞', '助詞']
を知って	['助詞', '動詞', '助詞']
をつけて	['助詞', '動詞', '助詞']
会社が	['名詞', '助詞']
彼が	['名詞', '助詞']
これまでの	['名詞', '助詞', '助詞']
は日本	['助詞', '名詞']
のほか	['助詞', '名詞']
額の	['名詞', '助詞']
が出た	['助詞', '動詞', '助動詞']
声が	['名詞', '助詞']
体に	['名詞', '助詞']
事に	['名詞', '助詞']
料金が	['名詞', '助詞']
を発見	['助詞', '名詞']
のかもしれない	['名詞', '助詞', '動詞', '助動詞']
品の	['名詞', '助詞']
ことができ	['名詞', '助詞', '動詞']
を変える	['助詞', '動詞']
これに	['名詞', '助詞']
に興味	['助詞', '名詞']
を活か	['助詞', '名詞', '助詞']
弊社は	['名詞', '助詞']
といいます	['助詞', '動詞', '助動詞']
自動的に	['名詞', '助詞']
を利用	['助詞', '名詞']
が非常に	['助詞', '名詞', '助詞']
を経て	['助詞', '動詞', '助詞']
の生活	['助詞', '名詞']
ただの	['名詞', '助詞']
ズの	['名詞', '助詞']
というより	['助詞', '動詞', '助詞']
の可能性	['助詞', '名詞', '名詞']
時間に	['名詞', '助詞']
分で	['名詞', '助詞']
写真を	['名詞', '助詞']
になれ	['助詞', '動詞']
声を	['名詞', '助詞']
どちらも	['名詞', '助詞']
になりたい	['助詞', '動詞', '助動詞']
話は	['名詞', '助詞']
人も多い	['名詞', '助詞', '形容詞']
お金を借りる	['名詞', '助詞', '動詞']
といって	['助詞', '動詞', '助詞']
ってみた	['助詞', '動詞', '助動詞']
下に	['名詞', '助詞']
にい	['助詞', '動詞']
誰もが	['名詞', '助詞', '助詞']
所の	['名詞', '助詞']
周りの	['名詞', '助詞']
の姿	['助詞', '名詞']
のとおり	['助詞', '名詞']
と言われています	['助詞', '動詞', '動詞', '助詞', '動詞', '助動詞']
私に	['名詞', '助詞']
元の	['名詞', '助詞']
度の	['名詞', '助詞']
気の	['名詞', '助詞']
の音	['助詞', '名詞']
を聞いて	['助詞', '動詞', '助詞']
サイズの	['名詞', '助詞']
をつけ	['助詞', '名詞']
はコチラ	['助詞', '名詞']
の目	['助詞', '名詞']
以外にも	['名詞', '助詞', '助詞']
の皆様	['助詞', '名詞']
の部分	['助詞', '名詞']
サイトは	['名詞', '助詞']
を求め	['助詞', '動詞']
の発	['助詞', '名詞']
力で	['名詞', '助詞']
好みの	['名詞', '助詞']
が重要	['助詞', '名詞']
際は	['名詞', '助詞']
をしています	['助詞', '動詞', '助詞', '動詞', '助動詞']
の基本	['助詞', '名詞']
面で	['名詞', '助詞']
を考慮	['助詞', '名詞']
物は	['名詞', '助詞']
身の	['名詞', '助詞']
を試	['助詞', '名詞']
らは	['名詞', '助詞']
の間で	['助詞', '名詞', '助詞']
としたら	['助詞', '動詞', '助動詞']
を有する	['助詞', '動詞']
ポイントが	['名詞', '助詞']
屋の	['名詞', '助詞']
気持ちが	['名詞', '助詞']
思いを	['名詞', '助詞']
のお知らせ	['助詞', '名詞']
彼らの	['名詞', '助詞']
今でも	['名詞', '助詞', '助詞']
になりますが	['助詞', '動詞', '助動詞', '助詞']
を表示する	['助詞', '名詞', '動詞']
に比べ	['助詞', '動詞']
心が	['名詞', '助詞']
の際は	['助詞', '名詞', '助詞']
を提供する	['助詞', '名詞', '動詞']
通りに	['名詞', '助詞']
の時代	['助詞', '名詞']
を忘れ	['助詞', '動詞']
を考えて	['助詞', '動詞', '助詞']
のお客様	['助詞', '名詞']
の価値	['助詞', '名詞']
価格の	['名詞', '助詞']
の香り	['助詞', '名詞']
は無	['助詞', '名詞']
の森	['助詞', '名詞']
に合った	['助詞', '動詞', '助動詞']
部分は	['名詞', '助詞']
朝から	['名詞', '助詞']
も出	['助詞', '動詞']
世界に	['名詞', '助詞']
の高	['助詞', '名詞']
をとる	['助詞', '動詞']
参考に	['名詞', '助詞']
部に	['名詞', '助詞']
段階で	['名詞', '助詞']
詳細はこちら	['名詞', '助詞', '名詞']
子を	['名詞', '助詞']
になれる	['助詞', '動詞']
を検索	['助詞', '名詞']
男性は	['名詞', '助詞']
の悩み	['助詞', '名詞']
をお願い	['助詞', '名詞']
自宅で	['名詞', '助詞']
の山	['助詞', '名詞']
レベルの	['名詞', '助詞']
女性と	['名詞', '助詞']
海の	['名詞', '助詞']
感を	['名詞', '助詞']
は今	['助詞', '名詞']
際の	['名詞', '助詞']
式の	['名詞', '助詞']
時間も	['名詞', '助詞']
を使用する	['助詞', '名詞', '動詞']
の差	['助詞', '名詞']
になれば	['助詞', '動詞', '助詞']
にほんブログ村	['助詞', '名詞', '名詞', '名詞']
明日は	['名詞', '助詞']
プロの	['名詞', '助詞']
と言った	['助詞', '動詞', '助動詞']
は必要	['助詞', '名詞']
に入れる	['助詞', '動詞']
秋の	['名詞', '助詞']
がありますので	['助詞', '動詞', '助動詞', '助詞']
の場所	['助詞', '名詞']
が来る	['助詞', '動詞']
手軽に	['名詞', '助詞']
金を	['名詞', '助詞']
春の	['名詞', '助詞']
らが	['名詞', '助詞']
んだり	['名詞', '助詞']
達の	['名詞', '助詞']
ってしまいます	['助詞', '動詞', '助動詞']
度に	['名詞', '助詞']
の変更	['助詞', '名詞']
を入れる	['助詞', '動詞']
を挙げ	['助詞', '動詞']
人が多い	['名詞', '助詞', '形容詞']
年には	['名詞', '助詞', '助詞']
誰が	['名詞', '助詞']
を獲得	['助詞', '名詞']
がつく	['助詞', '動詞']
点を	['名詞', '助詞']
に挑戦	['助詞', '名詞']
を用いて	['助詞', '動詞', '助詞']
も見	['助詞', '動詞']
木の	['名詞', '助詞']
をすると	['助詞', '動詞', '助詞']
を発揮	['助詞', '名詞']
を増や	['助詞', '名詞', '助動詞']
それなりに	['名詞', '助詞']
価格が	['名詞', '助詞']
てきて	['助詞', '動詞', '助詞']
を含	['助詞', '名詞']
お気に入りの	['名詞', '助詞']
等は	['名詞', '助詞']
水を	['名詞', '助詞']
の部屋	['助詞', '名詞']
と呼ばれ	['助詞', '動詞', '動詞']
今も	['名詞', '助詞']
と感じる	['助詞', '動詞']
になってしまった	['助詞', '動詞', '助詞', '動詞', '助動詞']
姿を	['名詞', '助詞']
本気で	['名詞', '助詞']
どれも	['名詞', '助詞']
冬の	['名詞', '助詞']
と考えている	['助詞', '動詞', '助詞', '動詞']
の相談	['助詞', '名詞']
は見	['助詞', '動詞']
ことの	['名詞', '助詞']
ホテルの	['名詞', '助詞']
システムの	['名詞', '助詞']
を維持	['助詞', '名詞']
を重ね	['助詞', '動詞']
というわけで	['助詞', '名詞', '助動詞']
状況を	['名詞', '助詞']
を確保	['助詞', '名詞']
に戻	['助詞', '動詞']
に見える	['助詞', '動詞']
に相談	['助詞', '名詞']
頭の	['名詞', '助詞']
と比べて	['助詞', '動詞', '助詞']
の治療	['助詞', '名詞']
の位置	['助詞', '名詞']
こともあり	['名詞', '助詞', '動詞']
を探して	['助詞', '動詞', '助詞']
曲が	['名詞', '助詞']
があるから	['助詞', '動詞', '助詞']
につながる	['助詞', '動詞']
が変わる	['助詞', '動詞']
以前から	['名詞', '助詞']
本日の	['名詞', '助詞']
費用は	['名詞', '助詞']
を担当	['助詞', '名詞']
と言われて	['助詞', '動詞', '動詞', '助詞']
君の	['名詞', '助詞']
んと	['名詞', '助詞']
面の	['名詞', '助詞']
場所は	['名詞', '助詞']
年は	['名詞', '助詞']
があっても	['助詞', '動詞', '助詞', '助詞']
の発言	['助詞', '名詞']
が出てくる	['助詞', '動詞', '助詞', '動詞']
の顔	['助詞', '名詞']
を設け	['助詞', '動詞']
量は	['名詞', '助詞']
ようになります	['名詞', '助詞', '動詞', '助動詞']
従来の	['名詞', '助詞']
の小	['助詞', '名詞']
を守	['助詞', '名詞']
最近では	['名詞', '助詞', '助詞']
をかける	['助詞', '動詞']
を読み	['助詞', '動詞']
下記の	['名詞', '助詞']
夜は	['名詞', '助詞']
上から	['名詞', '助詞']
料金は	['名詞', '助詞']
を一	['助詞', '名詞']
料金を	['名詞', '助詞']
楽しみにして	['名詞', '助詞', '動詞', '助詞']
に基づいて	['助詞', '動詞', '助詞']
近所の	['名詞', '助詞']
を行っている	['助詞', '動詞', '助詞', '動詞']
ていますが	['助詞', '動詞', '助動詞', '助詞']
今までの	['名詞', '助詞', '助詞']
と話	['助詞', '名詞']
やかに	['助詞', '名詞']
と思われ	['助詞', '動詞', '動詞']
部分が	['名詞', '助詞']
どこでも	['名詞', '助詞', '助詞']
時間で	['名詞', '助詞']
デザインの	['名詞', '助詞']
に出て	['助詞', '動詞', '助詞']
皆さんの	['名詞', '助詞']
の味	['助詞', '名詞']
を選び	['助詞', '動詞']
の男性	['助詞', '名詞']
例の	['名詞', '助詞']
の画像	['助詞', '名詞']
のイベント	['助詞', '名詞']
を広げ	['助詞', '動詞']
はち	['助詞', '動詞']
に来た	['助詞', '動詞', '助動詞']
等に	['名詞', '助詞']
の形	['助詞', '名詞']
肌が	['名詞', '助詞']
の対応	['助詞', '名詞']
月は	['名詞', '助詞']
際には	['名詞', '助詞', '助詞']
を入力	['助詞', '名詞']
自体が	['名詞', '助詞']
サイトに	['名詞', '助詞']
率は	['名詞', '助詞']
量が	['名詞', '助詞']
に登録	['助詞', '名詞']
が続く	['助詞', '動詞']
地に	['名詞', '助詞']
相手を	['名詞', '助詞']
形の	['名詞', '助詞']
を認め	['助詞', '動詞']
頃に	['名詞', '助詞']
過去に	['名詞', '助詞']
をつける	['助詞', '動詞']
区の	['名詞', '助詞']
方法が	['名詞', '助詞']
もありました	['助詞', '動詞', '助動詞', '助動詞']
の理由	['助詞', '名詞']
専用の	['名詞', '助詞']
関係の	['名詞', '助詞']
最後は	['名詞', '助詞']
質な	['名詞', '助詞']
機能を	['名詞', '助詞']
を繰り返し	['助詞', '動詞']
年度の	['名詞', '助詞']
費用の	['名詞', '助詞']
をお願いします	['助詞', '名詞', '動詞', '助動詞']
の賃貸物件	['助詞', '名詞', '名詞']
的にも	['名詞', '助詞', '助詞']
村の	['名詞', '助詞']
は一	['助詞', '名詞']
のサイト	['助詞', '名詞']
点が	['名詞', '助詞']
の評判	['助詞', '名詞']
の元	['助詞', '名詞']
自体は	['名詞', '助詞']
を除	['助詞', '名詞']
のおかげで	['助詞', '名詞', '助詞']
性と	['名詞', '助詞']
の旅	['助詞', '名詞']
感のある	['名詞', '助詞', '動詞']
がんば	['名詞', '助詞']
母の日	['名詞', '助詞', '名詞']
安心の	['名詞', '助詞']
と繋がりたい	['助詞', '動詞', '助動詞']
人でも	['名詞', '助詞', '助詞']
があるのか	['助詞', '動詞', '名詞', '助詞']
前は	['名詞', '助詞']
顔の	['名詞', '助詞']
口に	['名詞', '助詞']
に至	['助詞', '名詞']
の場	['助詞', '名詞']
業者は	['名詞', '助詞']
も可能	['助詞', '名詞']
綺麗に	['名詞', '助詞']
の技術	['助詞', '名詞']
を下	['助詞', '名詞']
線を	['名詞', '助詞']
に乗	['助詞', '動詞']
を実行	['助詞', '名詞']
個人の	['名詞', '助詞']
部分を	['名詞', '助詞']
口コミで検討でき	['名詞', '助詞', '名詞', '動詞']
自分も	['名詞', '助詞']
方がいい	['名詞', '助詞', '形容詞']
の対象	['助詞', '名詞']
部分に	['名詞', '助詞']
を意識	['助詞', '名詞']
通りの	['名詞', '助詞']
足の	['名詞', '助詞']
力は	['名詞', '助詞']
のポイント	['助詞', '名詞']
を誇る	['助詞', '動詞']
を設置	['助詞', '名詞']
と言われた	['助詞', '動詞', '動詞', '助動詞']
効果がある	['名詞', '助詞', '動詞']
時も	['名詞', '助詞']
に合う	['助詞', '動詞']
と聞いて	['助詞', '動詞', '助詞']
を上げ	['助詞', '動詞']
に基づく	['助詞', '動詞']
早めに	['名詞', '助詞']
スタッフが	['名詞', '助詞']
を発	['助詞', '名詞']
ほかの	['名詞', '助詞']
の為に	['助詞', '名詞', '助詞']
場に	['名詞', '助詞']
のアニ	['助詞', '名詞']
にしている	['助詞', '動詞', '助詞', '動詞']
が増える	['助詞', '動詞']
面に	['名詞', '助詞']
ってしまいました	['助詞', '動詞', '助動詞', '助動詞']
関連の	['名詞', '助詞']
をつく	['助詞', '動詞']
の不動産	['助詞', '名詞']
多くの方	['名詞', '助詞', '名詞']
朝の	['名詞', '助詞']
価格を	['名詞', '助詞']
の確認	['助詞', '名詞']
達が	['名詞', '助詞']
と出会って	['助詞', '動詞', '助詞']
というところ	['助詞', '名詞']
を導入	['助詞', '名詞']
の使い方	['助詞', '名詞']
いずれも	['名詞', '助詞']
の雰囲気	['助詞', '名詞']
ようになり	['名詞', '助詞', '動詞']
の動画	['助詞', '名詞']
とされる	['助詞', '動詞', '動詞']
記事を	['名詞', '助詞']
を観	['助詞', '動詞']
という方	['助詞', '名詞']
車が	['名詞', '助詞']
以外は	['名詞', '助詞']
をすること	['助詞', '動詞', '名詞']
の歌	['助詞', '名詞']
オススメの	['名詞', '助詞']
我が家の	['名詞', '助詞']
テレビで	['名詞', '助詞']
になってから	['助詞', '動詞', '助詞', '助詞']
光の	['名詞', '助詞']
ようになる	['名詞', '助詞', '動詞']
のサイズ	['助詞', '名詞']
分に	['名詞', '助詞']
と違って	['助詞', '動詞', '助詞']
お世話にな	['名詞', '助詞', '助詞']
を掲載	['助詞', '名詞']
と言います	['助詞', '動詞', '助動詞']
選手が	['名詞', '助詞']
のプロ	['助詞', '名詞']
韓国の	['名詞', '助詞']
てくれます	['助詞', '動詞', '助動詞']
前回の	['名詞', '助詞']
もいる	['助詞', '動詞']
になっても	['助詞', '動詞', '助詞', '助詞']
の質	['助詞', '名詞']
彼女が	['名詞', '助詞']
世界で	['名詞', '助詞']
大事に	['名詞', '助詞']
名は	['名詞', '助詞']
日には	['名詞', '助詞', '助詞']
も含めて	['助詞', '動詞', '助詞']
スは	['名詞', '助詞']
人間が	['名詞', '助詞']
を目指	['助詞', '名詞']
がみ	['助詞', '動詞']
の買取	['助詞', '名詞']
点で	['名詞', '助詞']
方向に	['名詞', '助詞']
の外	['助詞', '名詞']
の時期	['助詞', '名詞']
川の	['名詞', '助詞']
の痛み	['助詞', '名詞']
をまとめて	['助詞', '動詞', '助詞']
どこまで	['名詞', '助詞']
こちらの商品は	['名詞', '助詞', '名詞', '助詞']
はありませんが	['助詞', '動詞', '助動詞', '助動詞', '助詞']
んに	['名詞', '助詞']
の際	['助詞', '名詞']
学校の	['名詞', '助詞']
日より	['名詞', '助詞']
と考えて	['助詞', '動詞', '助詞']
は別	['助詞', '名詞']
は一切	['助詞', '名詞']
によれば	['助詞', '動詞', '助詞']
家を売る	['名詞', '助詞', '動詞']
をしました	['助詞', '動詞', '助動詞', '助動詞']
の人は	['助詞', '名詞', '助詞']
で見る	['助詞', '動詞']
を着	['助詞', '名詞']
会社は	['名詞', '助詞']
を高め	['助詞', '名詞']
先生が	['名詞', '助詞']
書の	['名詞', '助詞']
ここの	['名詞', '助詞']
大手の	['名詞', '助詞']
のやり取り	['助詞', '名詞']
を買い	['助詞', '動詞']
ができた	['助詞', '動詞', '助動詞']
繋が	['名詞', '助詞']
と見	['助詞', '動詞']
の海	['助詞', '名詞']
機の	['名詞', '助詞']
問題が	['名詞', '助詞']
に戻る	['助詞', '動詞']
頃の	['名詞', '助詞']
費用を	['名詞', '助詞']
の範囲	['助詞', '名詞']
外の	['名詞', '助詞']
わたしは	['名詞', '助詞']
の研究	['助詞', '名詞']
を利用した	['助詞', '名詞', '動詞', '助動詞']
映画の	['名詞', '助詞']
と言える	['助詞', '動詞']
の風	['助詞', '名詞']
どれくらい	['名詞', '助詞']
隣の	['名詞', '助詞']
男が	['名詞', '助詞']
名を	['名詞', '助詞']
を図	['助詞', '名詞']
弊社では	['名詞', '助詞', '助詞']
選手の	['名詞', '助詞']
神の	['名詞', '助詞']
んでいます	['助詞', '動詞', '助動詞']
大量に	['名詞', '助詞']
を紹介します	['助詞', '名詞', '動詞', '助動詞']
きれいに	['名詞', '助詞']
日本人の	['名詞', '助詞']
を食べる	['助詞', '動詞']
てみると	['助詞', '動詞', '助詞']
たりする	['助詞', '動詞']
頻繁に	['名詞', '助詞']
の感想	['助詞', '名詞']
を購入する	['助詞', '名詞', '動詞']
今回も	['名詞', '助詞']
割と	['名詞', '助詞']
ていると	['助詞', '動詞', '助詞']
の前で	['助詞', '名詞', '助詞']
ポイントを	['名詞', '助詞']
どこの	['名詞', '助詞']
付きの	['名詞', '助詞']
にいた	['助詞', '動詞', '助動詞']
に寄	['助詞', '名詞']
をとって	['助詞', '動詞', '助詞']
が取れ	['助詞', '動詞']
も増え	['助詞', '動詞']
ができて	['助詞', '動詞', '助詞']
本来の	['名詞', '助詞']
を味わ	['助詞', '名詞', '助詞']
計画の	['名詞', '助詞']
に来る	['助詞', '動詞']
人から	['名詞', '助詞']
のカ	['助詞', '名詞']
会社で	['名詞', '助詞']
がいない	['助詞', '動詞', '助動詞']
もたくさん	['助詞', '名詞']
を手に入れ	['助詞', '名詞', '助詞', '動詞']
にしたい	['助詞', '動詞', '助動詞']
を続け	['助詞', '動詞']
の費用	['助詞', '名詞']
何の	['名詞', '助詞']
に変え	['助詞', '動詞']
を変え	['助詞', '動詞']
があったり	['助詞', '動詞', '助詞']
率が	['名詞', '助詞']
結果を	['名詞', '助詞']
のとき	['助詞', '名詞']
頭を	['名詞', '助詞']
たちに	['名詞', '助詞']
はしない	['助詞', '動詞', '助動詞']
人がいる	['名詞', '助詞', '動詞']
のようです	['助詞', '名詞', '助動詞']
戦で	['名詞', '助詞']
仕事に	['名詞', '助詞']
会社を	['名詞', '助詞']
はすべて	['助詞', '名詞']
子と	['名詞', '助詞']
めで	['名詞', '助詞']
が可能な	['助詞', '名詞', '助動詞']
を結	['助詞', '名詞']
に出る	['助詞', '動詞']
施設の	['名詞', '助詞']
毎日の	['名詞', '助詞']
を使用し	['助詞', '名詞', '動詞']
を目指して	['助詞', '動詞', '助詞']
猫の	['名詞', '助詞']
の活動	['助詞', '名詞']
に使う	['助詞', '動詞']
者と	['名詞', '助詞']
書を	['名詞', '助詞']
を上げる	['助詞', '動詞']
を眺め	['助詞', '名詞']
身を	['名詞', '助詞']
な雰囲気	['助詞', '名詞']
を果た	['助詞', '名詞', '助動詞']
を見ながら	['助詞', '動詞', '助詞']
費用が	['名詞', '助詞']
があったので	['助詞', '動詞', '助動詞', '助詞']
方も多い	['名詞', '助詞', '形容詞']
本物の	['名詞', '助詞']
ていきます	['助詞', '動詞', '助動詞']
の上で	['助詞', '名詞', '助詞']
を公開	['助詞', '名詞']
昔は	['名詞', '助詞']
に掲載	['助詞', '名詞']
の読	['助詞', '名詞']
を大切に	['助詞', '名詞', '助詞']
国民の	['名詞', '助詞']
日本が	['名詞', '助詞']
にしました	['助詞', '動詞', '助動詞', '助動詞']
は全て	['助詞', '名詞']
の先	['助詞', '名詞']
があるため	['助詞', '動詞', '名詞']
の最新	['助詞', '名詞']
がわかる	['助詞', '動詞']
になったり	['助詞', '動詞', '助詞']
大幅に	['名詞', '助詞']
のなかで	['助詞', '名詞', '助詞']
本物と	['名詞', '助詞']
事業の	['名詞', '助詞']
画像は	['名詞', '助詞']
生活を	['名詞', '助詞']
は大変	['助詞', '名詞']
ところを	['名詞', '助詞']
に行ってきました	['助詞', '動詞', '助詞', '動詞', '助動詞', '助動詞']
女性を	['名詞', '助詞']
を目的と	['助詞', '名詞', '助詞']
を書き	['助詞', '動詞']
数を	['名詞', '助詞']
出会いの	['名詞', '助詞']
以降の	['名詞', '助詞']
を抑え	['助詞', '動詞']
ポイントは	['名詞', '助詞']
を付け	['助詞', '名詞']
男は	['名詞', '助詞']
方で	['名詞', '助詞']
相場の	['名詞', '助詞']
サイトが	['名詞', '助詞']
家が	['名詞', '助詞']
唯一の	['名詞', '助詞']
写真の	['名詞', '助詞']
の中心	['助詞', '名詞']
台の	['名詞', '助詞']
の目的	['助詞', '名詞']
快適に	['名詞', '助詞']
量の	['名詞', '助詞']
量を	['名詞', '助詞']
がかかります	['助詞', '動詞', '助動詞']
どちらか	['名詞', '助詞']
をしたり	['助詞', '動詞', '助詞']
の向上	['助詞', '名詞']
かも知れません	['助詞', '動詞', '助動詞', '助動詞']
を求めて	['助詞', '動詞', '助詞']
の仕方	['助詞', '名詞']
なにか	['名詞', '助詞']
そこは	['名詞', '助詞']
の先生	['助詞', '名詞']
に乗り	['助詞', '動詞']
以前の	['名詞', '助詞']
の立場	['助詞', '名詞']
役に立	['名詞', '助詞', '名詞']
当店は	['名詞', '助詞']
の規定	['助詞', '名詞']
は無理	['助詞', '名詞']
当時は	['名詞', '助詞']
一定の	['名詞', '助詞']
社会の	['名詞', '助詞']
自然に	['名詞', '助詞']
を高める	['助詞', '動詞']
と言えます	['助詞', '動詞', '助動詞']
薬の	['名詞', '助詞']
を行うこと	['助詞', '動詞', '名詞']
の頃	['助詞', '名詞']
部屋に	['名詞', '助詞']
に向けた	['助詞', '動詞', '助動詞']
名が	['名詞', '助詞']
状態に	['名詞', '助詞']
の脱毛	['助詞', '名詞']
色は	['名詞', '助詞']
という意味	['助詞', '名詞']
につきまして	['助詞', '動詞', '助動詞', '助詞']
年間の	['名詞', '助詞']
効果の	['名詞', '助詞']
以前に	['名詞', '助詞']
を考えると	['助詞', '動詞', '助詞']
多数の	['名詞', '助詞']
ことによって	['名詞', '助詞']
会で	['名詞', '助詞']
出身の	['名詞', '助詞']
が起き	['助詞', '動詞']
以内に	['名詞', '助詞']
場所を	['名詞', '助詞']
料金の	['名詞', '助詞']
に転	['助詞', '名詞']
軍の	['名詞', '助詞']
以前は	['名詞', '助詞']
原因は	['名詞', '助詞']
企業が	['名詞', '助詞']
詳細を見る	['名詞', '助詞', '動詞']
おかげで	['名詞', '助詞']
を確認する	['助詞', '名詞', '動詞']
気持ちを	['名詞', '助詞']
に比べると	['助詞', '動詞', '助詞']
の無料	['助詞', '名詞']
髪の	['名詞', '助詞']
うえで	['名詞', '助詞']
を覚え	['助詞', '動詞']
ことと	['名詞', '助詞']
に加えて	['助詞', '動詞', '助詞']
に行きました	['助詞', '動詞', '助動詞', '助動詞']
を用いた	['助詞', '動詞', '助動詞']
にち	['助詞', '動詞']
を担	['助詞', '名詞']
と考えております	['助詞', '動詞', '助詞', '動詞', '助動詞']
の条件	['助詞', '名詞']
を始める	['助詞', '動詞']
いもの	['名詞', '助詞']
を決める	['助詞', '動詞']
足を	['名詞', '助詞']
を得て	['助詞', '動詞', '助詞']
のせい	['助詞', '名詞']
不動産の	['名詞', '助詞']
を更新	['助詞', '名詞']
作品を	['名詞', '助詞']
に基づき	['助詞', '動詞']
関係を	['名詞', '助詞']
の夢	['助詞', '名詞']
上手に	['名詞', '助詞']
を楽しんで	['助詞', '動詞', '助詞']
はありますが	['助詞', '動詞', '助動詞', '助詞']
等が	['名詞', '助詞']
アプリの	['名詞', '助詞']
になってる	['助詞', '動詞', '動詞']
顔が	['名詞', '助詞']
僕も	['名詞', '助詞']
の出会い	['助詞', '名詞']
自身が	['名詞', '助詞']
を搭載	['助詞', '名詞']
品を	['名詞', '助詞']
の意見	['助詞', '名詞']
ように思います	['名詞', '助詞', '動詞', '助動詞']
を抱え	['助詞', '名詞']
に行くと	['助詞', '動詞', '助詞']
の改善	['助詞', '名詞']
かもしれませんね	['助詞', '動詞', '助動詞', '助動詞', '助詞']
ことにより	['名詞', '助詞']
の料金	['助詞', '名詞']
の調査	['助詞', '名詞']
ものも	['名詞', '助詞']
側は	['名詞', '助詞']
状の	['名詞', '助詞']
機能が	['名詞', '助詞']
時期に	['名詞', '助詞']
のある方	['助詞', '動詞', '名詞']
の比較	['助詞', '名詞']
になってしまいます	['助詞', '動詞', '助詞', '動詞', '助動詞']
に渡	['助詞', '名詞']
といえる	['助詞', '動詞']
と思っております	['助詞', '動詞', '助詞', '動詞', '助動詞']
額を	['名詞', '助詞']
に移動	['助詞', '名詞']
てしまって	['助詞', '動詞', '助詞']
と思うと	['助詞', '動詞', '助詞']
の対	['助詞', '名詞']
家族の	['名詞', '助詞']
方へ	['名詞', '助詞']
本日は	['名詞', '助詞']
を参考に	['助詞', '名詞', '助詞']
対応の	['名詞', '助詞']
が増えて	['助詞', '動詞', '助詞']
の予約	['助詞', '名詞']
の親	['助詞', '名詞']
かわからない	['助詞', '動詞', '助動詞']
に陥	['助詞', '動詞']
のバランス	['助詞', '名詞']
が入る	['助詞', '動詞']
の下に	['助詞', '名詞', '助詞']
を展開	['助詞', '名詞']
の組み合わせ	['助詞', '名詞']
審査が	['名詞', '助詞']
出会いがない	['名詞', '助詞', '形容詞']
が異なる	['助詞', '動詞']
雨の	['名詞', '助詞']
夢の	['名詞', '助詞']
お客様が	['名詞', '助詞']
に到着	['助詞', '名詞']
を生か	['助詞', '名詞', '助詞']
を切り	['助詞', '動詞']
となりますので	['助詞', '動詞', '助動詞', '助詞']
性は	['名詞', '助詞']
の方から	['助詞', '名詞', '助詞']
普段は	['名詞', '助詞']
内容が	['名詞', '助詞']
ンは	['名詞', '助詞']
を聴	['助詞', '名詞']
を負	['助詞', '名詞']
に追加	['助詞', '名詞']
明確に	['名詞', '助詞']
の奥	['助詞', '名詞']
を渡	['助詞', '名詞']
自然と	['名詞', '助詞']
なデザイン	['助詞', '名詞']
って言って	['助詞', '動詞', '助詞']
昨年の	['名詞', '助詞']
外に	['名詞', '助詞']
を立て	['助詞', '動詞']
を変更	['助詞', '名詞']
無事に	['名詞', '助詞']
を作った	['助詞', '動詞', '助動詞']
のメリット	['助詞', '名詞']
の街	['助詞', '名詞']
に合わせた	['助詞', '動詞', '助動詞']
てみた	['助詞', '動詞', '助動詞']
ラの	['名詞', '助詞']
にすると	['助詞', '動詞', '助詞']
を放	['助詞', '動詞']
ておく	['助詞', '動詞']
に帰	['助詞', '名詞']
スタッフの	['名詞', '助詞']
外で	['名詞', '助詞']
国が	['名詞', '助詞']
サイズは	['名詞', '助詞']
みんなが	['名詞', '助詞']
の方の	['助詞', '名詞', '助詞']
差が	['名詞', '助詞']
のようなもの	['助詞', '名詞', '助動詞', '名詞']
それらの	['名詞', '助詞']
に触れ	['助詞', '動詞']
ていません	['助詞', '動詞', '助動詞', '助動詞']
査定を	['名詞', '助詞']
を図る	['助詞', '動詞']
ってください	['助詞', '動詞']
大切に	['名詞', '助詞']
目の前	['名詞', '助詞', '名詞']
成分が	['名詞', '助詞']
に伴う	['助詞', '動詞']
うちは	['名詞', '助詞']
ことが出来ます	['名詞', '助詞', '動詞', '助動詞']
の壁	['助詞', '名詞']
写真を撮	['名詞', '助詞', '動詞']
の距離	['助詞', '名詞']
話の	['名詞', '助詞']
があったら	['助詞', '動詞', '助動詞']
毛が	['名詞', '助詞']
と判断	['助詞', '名詞']
母の	['名詞', '助詞']
真剣に	['名詞', '助詞']
意見を	['名詞', '助詞']
に住んで	['助詞', '動詞', '助詞']
ごとの	['名詞', '助詞']
を見つけて	['助詞', '動詞', '助詞']
を含め	['助詞', '動詞']
はできません	['助詞', '動詞', '助動詞', '助動詞']
肌を	['名詞', '助詞']
を取って	['助詞', '動詞', '助詞']
自らの	['名詞', '助詞']
犬の	['名詞', '助詞']
を探している	['助詞', '動詞', '助詞', '動詞']
対策を	['名詞', '助詞']
ことが出来る	['名詞', '助詞', '動詞']
の製造	['助詞', '名詞']
伸ば	['名詞', '助詞']
はこちらから	['助詞', '名詞', '助詞']
を指定	['助詞', '名詞']
に出演	['助詞', '名詞']
におすすめ	['助詞', '名詞']
場合でも	['名詞', '助詞', '助詞']
の成長	['助詞', '名詞']
に影響	['助詞', '名詞']
が続いて	['助詞', '動詞', '助詞']
方が良い	['名詞', '助詞', '形容詞']
を浴び	['助詞', '動詞']
後も	['名詞', '助詞']
をもとに	['助詞', '名詞', '助詞']
の査定	['助詞', '名詞']
業者を	['名詞', '助詞']
に残	['助詞', '名詞']
周りに	['名詞', '助詞']
に注意	['助詞', '名詞']
夫の	['名詞', '助詞']
さで	['名詞', '助詞']
銀行の	['名詞', '助詞']
に記載	['助詞', '名詞']
耳に	['名詞', '助詞']
戦の	['名詞', '助詞']
間は	['名詞', '助詞']
こも	['名詞', '助詞']
を教えて	['助詞', '動詞', '助詞']
を飲む	['助詞', '動詞']
に設定	['助詞', '名詞']
という感じ	['助詞', '名詞']
単純に	['名詞', '助詞']
からすると	['助詞', '動詞', '助詞']
家は	['名詞', '助詞']
ていること	['助詞', '動詞', '名詞']
ってしまい	['助詞', '動詞']
気になって	['名詞', '助詞', '動詞', '助詞']
が終わった	['助詞', '動詞', '助動詞']
を参照	['助詞', '名詞']
士の	['名詞', '助詞']
を出し	['助詞', '動詞']
はこれ	['助詞', '名詞']
写真が	['名詞', '助詞']
を始めた	['助詞', '動詞', '助動詞']
電話で	['名詞', '助詞']
の曲	['助詞', '名詞']
ってきます	['助詞', '動詞', '助動詞']
の検索結果	['助詞', '名詞', '名詞']
部分の	['名詞', '助詞']
を取り入れ	['助詞', '動詞']
口コミを	['名詞', '助詞']
の質問	['助詞', '名詞']
気になった	['名詞', '助詞', '動詞', '助動詞']
の責任	['助詞', '名詞']
ファイルを	['名詞', '助詞']
正確に	['名詞', '助詞']
弊社の	['名詞', '助詞']
てきている	['助詞', '動詞', '助詞', '動詞']
を重視	['助詞', '名詞']
を超えて	['助詞', '動詞', '助詞']
てみましょう	['助詞', '動詞', '助動詞', '助動詞']
達は	['名詞', '助詞']
をあげ	['助詞', '動詞']
部は	['名詞', '助詞']
んでいた	['名詞', '助詞', '動詞', '助動詞']
海外の	['名詞', '助詞']
いつまでも	['名詞', '助詞', '助詞']
独特の	['名詞', '助詞']
結果は	['名詞', '助詞']
専門の	['名詞', '助詞']
をつか	['助詞', '動詞']
はあります	['助詞', '動詞', '助動詞']
に伴い	['助詞', '動詞']
って何	['助詞', '名詞']
額は	['名詞', '助詞']
の反応	['助詞', '名詞']
程度で	['名詞', '助詞']
の情報を	['助詞', '名詞', '助詞']
さんを	['名詞', '助詞']
をこ	['助詞', '動詞']
ナの	['名詞', '助詞']
の役割	['助詞', '名詞']
道に	['名詞', '助詞']
期間は	['名詞', '助詞']
に注目	['助詞', '名詞']
が始まる	['助詞', '動詞']
病院で	['名詞', '助詞']
気になります	['名詞', '助詞', '動詞', '助動詞']
の売却	['助詞', '名詞']
以降は	['名詞', '助詞']
を探し	['助詞', '動詞']
を伸ば	['助詞', '名詞', '助詞']
も充実	['助詞', '名詞']
の作り方	['助詞', '名詞']
マンションの	['名詞', '助詞']
が入った	['助詞', '動詞', '助動詞']
曲を	['名詞', '助詞']
の練習	['助詞', '名詞']
と思うので	['助詞', '動詞', '助詞']
愛の	['名詞', '助詞']
口を	['名詞', '助詞']
お話を	['名詞', '助詞']
が生じ	['助詞', '動詞']
が付いて	['助詞', '動詞', '助詞']
妻の	['名詞', '助詞']
ようとする	['名詞', '助詞', '動詞']
なりに	['名詞', '助詞']
を聞き	['助詞', '動詞']
の作成	['助詞', '名詞']
今のところ	['名詞', '助詞', '名詞']
圧倒的に	['名詞', '助詞']
ためにも	['名詞', '助詞', '助詞']
の機能	['助詞', '名詞']
場合もあります	['名詞', '助詞', '動詞', '助動詞']
地域で	['名詞', '助詞']
めちゃ	['名詞', '助詞']
その後の	['名詞', '助詞']
というのを	['助詞', '名詞', '助詞']
理想の	['名詞', '助詞']
仕事で	['名詞', '助詞']
てくれて	['助詞', '動詞', '助詞']
の方へ	['助詞', '名詞', '助詞']
動画を	['名詞', '助詞']
の投稿	['助詞', '名詞']
の交換	['助詞', '名詞']
と感じました	['助詞', '動詞', '助動詞', '助動詞']
を迎える	['助詞', '動詞']
へ行く	['助詞', '動詞']
も豊富	['助詞', '名詞']
東京の	['名詞', '助詞']
の品質	['助詞', '名詞']
に乗る	['助詞', '動詞']
気を付け	['名詞', '助詞', '名詞']
ようにしましょう	['名詞', '助詞', '動詞', '助動詞', '助動詞']
の試合	['助詞', '名詞']
の愛	['助詞', '名詞']
画像を	['名詞', '助詞']
側から	['名詞', '助詞']
を置いて	['助詞', '動詞', '助詞']
の人に	['助詞', '名詞', '助詞']
に関わる	['助詞', '動詞']
げて	['名詞', '助詞']
はいない	['助詞', '動詞', '助動詞']
と思うのです	['助詞', '動詞', '名詞', '助動詞']
ことはできない	['名詞', '助詞', '動詞', '助動詞']
素材の	['名詞', '助詞']
を体験	['助詞', '名詞']
付きで	['名詞', '助詞']
薬を	['名詞', '助詞']
をひ	['助詞', '動詞']
味の	['名詞', '助詞']
の腕	['助詞', '名詞']
機に	['名詞', '助詞']
をしながら	['助詞', '動詞', '助詞']
分ほど	['名詞', '助詞']
を切	['助詞', '名詞']
汗を	['名詞', '助詞']
向けに	['名詞', '助詞']
オリジナルの	['名詞', '助詞']
世界を	['名詞', '助詞']
俺が	['名詞', '助詞']
をします	['助詞', '動詞', '助動詞']
のファン	['助詞', '名詞']
を整え	['助詞', '動詞']
街の	['名詞', '助詞']
と違う	['助詞', '動詞']
を知り	['助詞', '動詞']
体は	['名詞', '助詞']
契約を	['名詞', '助詞']
を信じ	['助詞', '動詞']
男性に	['名詞', '助詞']
の有無	['助詞', '名詞']
声で	['名詞', '助詞']
になってしまいました	['助詞', '動詞', '助詞', '動詞', '助動詞', '助動詞']
を向上させ	['助詞', '名詞', '動詞', '動詞']
ってのは	['助詞', '名詞', '助詞']
を防ぐ	['助詞', '動詞']
で出会った	['助詞', '動詞', '助動詞']
てみました	['助詞', '動詞', '助動詞', '助動詞']
におきまして	['助詞', '動詞', '助動詞', '助詞']
病院の	['名詞', '助詞']
先生に	['名詞', '助詞']
薬剤師の	['名詞', '助詞']
は避け	['助詞', '動詞']
のことです	['助詞', '名詞', '助動詞']
経験を	['名詞', '助詞']
と思える	['助詞', '動詞']
たりして	['助詞', '動詞', '助詞']
車は	['名詞', '助詞']
位に	['名詞', '助詞']
を使えば	['助詞', '動詞', '助詞']
嫌が	['名詞', '助詞']
になっていて	['助詞', '動詞', '助詞', '動詞', '助詞']
間で	['名詞', '助詞']
様は	['名詞', '助詞']
モデルの	['名詞', '助詞']
の転職	['助詞', '名詞']
って言う	['助詞', '動詞']
人間は	['名詞', '助詞']
わせて	['名詞', '助詞']
に限	['助詞', '名詞']
工事の	['名詞', '助詞']
先で	['名詞', '助詞']
をしない	['助詞', '動詞', '助動詞']
わきが	['名詞', '助詞']
声をかけ	['名詞', '助詞', '動詞']
参考にな	['名詞', '助詞', '助詞']
が来て	['助詞', '動詞', '助詞']
を捨て	['助詞', '動詞']
の総	['助詞', '名詞']
でやって	['助詞', '動詞', '助詞']
を手に	['助詞', '名詞', '助詞']
感は	['名詞', '助詞']
の映画	['助詞', '名詞']
が消え	['助詞', '動詞']
音を	['名詞', '助詞']
離島は	['名詞', '助詞']
に立ち	['助詞', '動詞']
ってくれた	['助詞', '動詞', '助動詞']
状態の	['名詞', '助詞']
の知識	['助詞', '名詞']
を実感	['助詞', '名詞']
駅で	['名詞', '助詞']
額が	['名詞', '助詞']
その後は	['名詞', '助詞']
というので	['助詞', '動詞', '助詞']
者として	['名詞', '助詞']
んか	['名詞', '助詞']
を応援	['助詞', '名詞']
の授業	['助詞', '名詞']
を許	['助詞', '名詞']
が見える	['助詞', '動詞']
作品の	['名詞', '助詞']
層の	['名詞', '助詞']
もいます	['助詞', '動詞', '助動詞']
近くで	['名詞', '助詞']
世界中の	['名詞', '助詞']
場を	['名詞', '助詞']
あなたも	['名詞', '助詞']
が上がる	['助詞', '動詞']
の音楽	['助詞', '名詞']
になっちゃ	['助詞', '動詞', '助詞']
を越え	['助詞', '動詞']
製品は	['名詞', '助詞']
地方の	['名詞', '助詞']
を加え	['助詞', '動詞']
建物の	['名詞', '助詞']
産の	['名詞', '助詞']
に限らず	['助詞', '動詞', '助動詞']
の女の子	['助詞', '名詞']
の季節	['助詞', '名詞']
君は	['名詞', '助詞']
費の	['名詞', '助詞']
の違いは	['助詞', '名詞', '助詞']
を変えて	['助詞', '動詞', '助詞']
を選んだ	['助詞', '動詞', '助動詞']
室の	['名詞', '助詞']
様が	['名詞', '助詞']
てしまうと	['助詞', '動詞', '助詞']
理由で	['名詞', '助詞']
に期待	['助詞', '名詞']
の登録	['助詞', '名詞']
ってみて	['助詞', '動詞', '助詞']
気がつ	['名詞', '助詞', '助動詞']
も必要	['助詞', '名詞']
といわれ	['助詞', '動詞', '動詞']
の導入	['助詞', '名詞']
はここ	['助詞', '名詞']
相場は	['名詞', '助詞']
を気に	['助詞', '名詞', '助詞']
風が	['名詞', '助詞']
が入っている	['助詞', '動詞', '助詞', '動詞']
に使える	['助詞', '動詞']
の悪	['助詞', '名詞']
どこで	['名詞', '助詞']
つつある	['助詞', '動詞']
ンが	['名詞', '助詞']
を得た	['助詞', '動詞', '助動詞']
にしろ	['助詞', '動詞']
を考えている	['助詞', '動詞', '助詞', '動詞']
もこ	['助詞', '動詞']
米国の	['名詞', '助詞']
を買った	['助詞', '動詞', '助動詞']
を目指し	['助詞', '動詞']
相手は	['名詞', '助詞']
があるか	['助詞', '動詞', '助詞']
場は	['名詞', '助詞']
を解消	['助詞', '名詞']
女の子と	['名詞', '助詞']
も含め	['助詞', '動詞']
ということも	['助詞', '名詞', '助詞']
の基礎	['助詞', '名詞']
をもつ	['助詞', '動詞']
を調べ	['助詞', '名詞']
を行な	['助詞', '名詞', '助詞']
今後は	['名詞', '助詞']
頭が	['名詞', '助詞']
を行っています	['助詞', '動詞', '助詞', '動詞', '助動詞']
を押	['助詞', '名詞']
後から	['名詞', '助詞']
ことが多いです	['名詞', '助詞', '形容詞', '助動詞']
をつくる	['助詞', '動詞']
の製品	['助詞', '名詞']
を飲んで	['助詞', '動詞', '助詞']
差は	['名詞', '助詞']
人もいます	['名詞', '助詞', '動詞', '助動詞']
ちゃんに	['名詞', '助詞']
のお話	['助詞', '名詞']
素直に	['名詞', '助詞']
の物件	['助詞', '名詞']
当社の	['名詞', '助詞']
月には	['名詞', '助詞', '助詞']
のいずれか	['助詞', '名詞', '助詞']
が増えた	['助詞', '動詞', '助動詞']
元気に	['名詞', '助詞']
同様に	['名詞', '助詞']
の増	['助詞', '名詞']
業界の	['名詞', '助詞']
に関する情報	['助詞', '名詞']
の戦い	['助詞', '名詞']
評判の	['名詞', '助詞']
職場の	['名詞', '助詞']
の選び方	['助詞', '名詞']
ていきたい	['助詞', '動詞', '助動詞']
沢山の	['名詞', '助詞']
作業を	['名詞', '助詞']
観点から	['名詞', '助詞']
の絵	['助詞', '名詞']
訳で	['名詞', '助詞']
先生は	['名詞', '助詞']
に感謝	['助詞', '名詞']
同様の	['名詞', '助詞']
こちらで	['名詞', '助詞']
を抑える	['助詞', '動詞']
画像の	['名詞', '助詞']
のかもしれませんが	['名詞', '助詞', '動詞', '助動詞', '助動詞', '助詞']
を隠	['助詞', '動詞']
の整備	['助詞', '名詞']
線が	['名詞', '助詞']
位で	['名詞', '助詞']
まれて	['名詞', '助詞']
をとり	['助詞', '動詞']
生まれの人	['名詞', '助詞', '名詞']
皆様の	['名詞', '助詞']
を使っている	['助詞', '動詞', '助詞', '動詞']
ブログに	['名詞', '助詞']
と考えます	['助詞', '動詞', '助動詞']
をやる	['助詞', '動詞']
を多く	['助詞', '名詞']
が来た	['助詞', '動詞', '助動詞']
足が	['名詞', '助詞']
のドレス	['助詞', '名詞']
と言われている	['助詞', '動詞', '動詞', '助詞', '動詞']
私と	['名詞', '助詞']
あれは	['名詞', '助詞']
たいという	['名詞', '助詞']
条件で	['名詞', '助詞']
気持ちで	['名詞', '助詞']
に置いて	['助詞', '動詞', '助詞']
を達成	['助詞', '名詞']
の負担	['助詞', '名詞']
夜に	['名詞', '助詞']
を募集	['助詞', '名詞']
個の	['名詞', '助詞']
二つの	['名詞', '助詞']
に役立つ	['助詞', '動詞']
笑顔で	['名詞', '助詞']
を増やす	['助詞', '動詞']
クラスの	['名詞', '助詞']
方が多い	['名詞', '助詞', '形容詞']
の多くは	['助詞', '名詞', '助詞']
脱毛を	['名詞', '助詞']
一番の	['名詞', '助詞']
をすべて	['助詞', '名詞']
お金の	['名詞', '助詞']
相場を	['名詞', '助詞']
というものは	['助詞', '名詞', '助詞']
におすすめの	['助詞', '名詞', '助詞']
くんの	['名詞', '助詞']
値を	['名詞', '助詞']
をたくさん	['助詞', '名詞']
相手と	['名詞', '助詞']
を削除	['助詞', '名詞']
の娘	['助詞', '名詞']
同士の	['名詞', '助詞']
技術を	['名詞', '助詞']
金額を	['名詞', '助詞']
になりそう	['助詞', '動詞', '名詞']
既存の	['名詞', '助詞']
手元に	['名詞', '助詞']
のようで	['助詞', '名詞', '助動詞']
めている	['名詞', '助詞', '動詞']
性の高い	['名詞', '助詞', '形容詞']
を招	['助詞', '名詞']
にアクセス	['助詞', '名詞']
買取の	['名詞', '助詞']
君が	['名詞', '助詞']
ことができました	['名詞', '助詞', '動詞', '助動詞', '助動詞']
そこには	['名詞', '助詞', '助詞']
次第で	['名詞', '助詞']
という気持ち	['助詞', '名詞']
市場の	['名詞', '助詞']
を打ち	['助詞', '動詞']
場合が	['名詞', '助詞']
信頼の	['名詞', '助詞']
を出した	['助詞', '動詞', '助動詞']
全員が	['名詞', '助詞']
に努め	['助詞', '動詞']
たちと	['名詞', '助詞']
を促	['助詞', '名詞']
髪を	['名詞', '助詞']
男と	['名詞', '助詞']
のせいで	['助詞', '名詞', '助動詞']
の文字	['助詞', '名詞']
の予定	['助詞', '名詞']
住宅の	['名詞', '助詞']
を伝え	['助詞', '動詞']
も可能です	['助詞', '名詞', '助動詞']
費を	['名詞', '助詞']
を紹介しています	['助詞', '名詞', '動詞', '助詞', '動詞', '助動詞']
に関連する	['助詞', '名詞', '動詞']
ホントに	['名詞', '助詞']
の葉	['助詞', '名詞']
調に	['名詞', '助詞']
駅から徒歩	['名詞', '助詞', '名詞']
を頼	['助詞', '名詞']
母が	['名詞', '助詞']
めば	['名詞', '助詞']
ブログで	['名詞', '助詞']
の考え方	['助詞', '名詞']
って事	['助詞', '名詞']
に戻って	['助詞', '動詞', '助詞']
を占め	['助詞', '動詞']
目的で	['名詞', '助詞']
に貢献	['助詞', '名詞']
がついた	['助詞', '動詞', '助動詞']
になってきた	['助詞', '動詞', '助詞', '動詞', '助動詞']
歳で	['名詞', '助詞']
しかありません	['助詞', '動詞', '助動詞', '助動詞']
私にとって	['名詞', '助詞']
に従って	['助詞', '動詞', '助詞']
ブラックでも借りれる	['名詞', '助詞', '動詞', '動詞']
に追い	['助詞', '動詞']
に設置	['助詞', '名詞']
なんてこと	['助詞', '名詞']
を代表する	['助詞', '名詞', '動詞']
を記録	['助詞', '名詞']
大人気の	['名詞', '助詞']
線で	['名詞', '助詞']
金額が	['名詞', '助詞']
が終わって	['助詞', '動詞', '助詞']
に一度	['助詞', '名詞', '名詞']
と比べると	['助詞', '動詞', '助詞']
に向かう	['助詞', '動詞']
に入っている	['助詞', '動詞', '助詞', '動詞']
を演じ	['助詞', '動詞']
を聞いた	['助詞', '動詞', '助動詞']
当社は	['名詞', '助詞']
に出かけ	['助詞', '動詞']
を見せて	['助詞', '動詞', '助詞']
ておきたい	['助詞', '動詞', '助動詞']
な印象	['助詞', '名詞']
の店舗	['助詞', '名詞']
を徹底	['助詞', '名詞']
ことが多く	['名詞', '助詞', '名詞']
のことで	['助詞', '名詞', '助動詞']
になるのは	['助詞', '動詞', '名詞', '助詞']
に接続	['助詞', '名詞']
味を	['名詞', '助詞']
以外で	['名詞', '助詞']
を思い出し	['助詞', '動詞']
服を	['名詞', '助詞']
の賃貸	['助詞', '名詞']
計画を	['名詞', '助詞']
親の	['名詞', '助詞']
も多数	['助詞', '名詞']
の課題	['助詞', '名詞']
の作業	['助詞', '名詞']
屋根の	['名詞', '助詞']
のトップ	['助詞', '名詞']
の症状	['助詞', '名詞']
を続ける	['助詞', '動詞']
ひとつの	['名詞', '助詞']
に携わ	['助詞', '動詞']
の割合	['助詞', '名詞']
級の	['名詞', '助詞']
が豊富	['助詞', '名詞']
製品を	['名詞', '助詞']
のスタッフ	['助詞', '名詞']
を聞く	['助詞', '動詞']
が生じる	['助詞', '動詞']
を利用し	['助詞', '名詞', '動詞']
帰りに	['名詞', '助詞']
こちらから	['名詞', '助詞']
の判断	['助詞', '名詞']
に行か	['助詞', '動詞']
子どもが	['名詞', '助詞']
に住む	['助詞', '動詞']
お互いに	['名詞', '助詞']
質問を	['名詞', '助詞']
自宅に	['名詞', '助詞']
に慣れ	['助詞', '動詞']
屋で	['名詞', '助詞']
が変わって	['助詞', '動詞', '助詞']
に囲まれ	['助詞', '動詞', '動詞']
自分でも	['名詞', '助詞', '助詞']
の引越し	['助詞', '名詞']
相場が	['名詞', '助詞']
明日の	['名詞', '助詞']
権を	['名詞', '助詞']
に最適	['助詞', '名詞']
もありますし	['助詞', '動詞', '助動詞', '助詞']
を提案	['助詞', '名詞']
で行く	['助詞', '動詞']
に落ち	['助詞', '動詞']
のレベル	['助詞', '名詞']
を呼び	['助詞', '動詞']
のクチコミ	['助詞', '名詞']
それだけで	['名詞', '助詞', '助動詞']
を取り戻	['助詞', '動詞', '動詞']
の話を	['助詞', '名詞', '助詞']
容易に	['名詞', '助詞']
以上で	['名詞', '助詞']
の取り組み	['助詞', '名詞']
を楽しみ	['助詞', '動詞']
を開く	['助詞', '動詞']
現場で	['名詞', '助詞']
の都合	['助詞', '名詞']
言葉で	['名詞', '助詞']
かも知れない	['助詞', '動詞', '助動詞']
を助け	['助詞', '動詞']
ところから	['名詞', '助詞']
を伝える	['助詞', '動詞']
を開発	['助詞', '名詞']
の話題	['助詞', '名詞']
の審査	['助詞', '名詞']
のライブ	['助詞', '名詞']
影響を与え	['名詞', '助詞', '動詞']
が入り	['助詞', '動詞']
に含まれる	['助詞', '動詞', '動詞']
を追求	['助詞', '名詞']
季節の	['名詞', '助詞']
に仕上げ	['助詞', '名詞']
に入れた	['助詞', '動詞', '助動詞']
言葉に	['名詞', '助詞']
の勉強	['助詞', '名詞']
注目の	['名詞', '助詞']
ってみよう	['助詞', '動詞', '助動詞']
となっており	['助詞', '動詞', '助詞', '動詞']
ってみました	['助詞', '動詞', '助動詞', '助動詞']
時間がかかる	['名詞', '助詞', '動詞']
後には	['名詞', '助詞', '助詞']
はずの	['名詞', '助詞']
は他の	['助詞', '名詞', '助詞']
を決め	['助詞', '動詞']
の一番	['助詞', '名詞']
特有の	['名詞', '助詞']
のかも	['助詞', '名詞']
日本でも	['名詞', '助詞', '助詞']
を持っています	['助詞', '動詞', '助詞', '動詞', '助動詞']
話題に	['名詞', '助詞']
の処理	['助詞', '名詞']
から探す	['助詞', '動詞']
女の子が	['名詞', '助詞']
を見つけた	['助詞', '動詞', '助動詞']
ことが可能です	['名詞', '助詞', '名詞', '助動詞']
言葉が	['名詞', '助詞']
わたしの	['名詞', '助詞']
大量の	['名詞', '助詞']
状況は	['名詞', '助詞']
単位で	['名詞', '助詞']
レベルで	['名詞', '助詞']
に通う	['助詞', '動詞']
で使える	['助詞', '動詞']
の自由	['助詞', '名詞']
を務め	['助詞', '名詞']
友達と	['名詞', '助詞']
を描く	['助詞', '動詞']
に応え	['助詞', '動詞']
美人の	['名詞', '助詞']
っていうのは	['助詞', '名詞', '助詞']
ますから	['名詞', '助詞']
当初は	['名詞', '助詞']
で行う	['助詞', '動詞']
ものがある	['名詞', '助詞', '動詞']
を対象に	['助詞', '名詞', '助詞']
の実施	['助詞', '名詞']
を必要と	['助詞', '名詞', '助詞']
の宿	['助詞', '名詞']
食事を	['名詞', '助詞']
人気のある	['名詞', '助詞', '動詞']
を下げ	['助詞', '名詞']
になるのか	['助詞', '動詞', '名詞', '助詞']
を踏まえ	['助詞', '動詞']
と感じた	['助詞', '動詞', '助動詞']
雨が降	['名詞', '助詞', '動詞']
の持ち	['助詞', '動詞']
値は	['名詞', '助詞']
ておき	['助詞', '動詞']
あとで	['名詞', '助詞']
スマホで	['名詞', '助詞']
を差し	['助詞', '動詞']
に最適な	['助詞', '名詞', '助動詞']
を行いました	['助詞', '動詞', '助動詞', '助動詞']
に引き	['助詞', '動詞']
は何も	['助詞', '名詞', '助詞']
全体を	['名詞', '助詞']
てしまえば	['助詞', '動詞', '助詞']
タイミングで	['名詞', '助詞']
職員の	['名詞', '助詞']
がわからない	['助詞', '動詞', '助動詞']
に行こう	['助詞', '動詞', '助動詞']
の影響で	['助詞', '名詞', '助詞']
に手を	['助詞', '名詞', '助詞']
の世界市場	['助詞', '名詞', '名詞']
あたりの	['名詞', '助詞']
員が	['名詞', '助詞']
がとれ	['助詞', '動詞']
が出ている	['助詞', '動詞', '助詞', '動詞']
年代の	['名詞', '助詞']
慎重に	['名詞', '助詞']
に変	['助詞', '名詞']
を感じて	['助詞', '動詞', '助詞']
が分かる	['助詞', '動詞']
気をつけて	['名詞', '助詞', '動詞', '助詞']
役の	['名詞', '助詞']
口コミで	['名詞', '助詞']
明か	['名詞', '助詞']
がありましたが	['助詞', '動詞', '助動詞', '助動詞', '助詞']
を送って	['助詞', '動詞', '助詞']
を深め	['助詞', '動詞']
が楽しめる	['助詞', '動詞']
を演出	['助詞', '名詞']
の契約	['助詞', '名詞']
親が	['名詞', '助詞']
をやめ	['助詞', '動詞']
の行動	['助詞', '名詞']
の運営	['助詞', '名詞']
の選択	['助詞', '名詞']
を超え	['助詞', '動詞']
の新作	['助詞', '名詞']
これまでに	['名詞', '助詞', '助詞']
を置く	['助詞', '動詞']
値が	['名詞', '助詞']
をすれば	['助詞', '動詞', '助詞']
周囲の	['名詞', '助詞']
現代の	['名詞', '助詞']
を共有	['助詞', '名詞']
なんていう	['名詞', '助詞']
全体に	['名詞', '助詞']
に誘	['助詞', '名詞']
気持ちは	['名詞', '助詞']
将来の	['名詞', '助詞']
どこが	['名詞', '助詞']
感覚で	['名詞', '助詞']
の設置	['助詞', '名詞']
ファイルの	['名詞', '助詞']
こだわりの	['名詞', '助詞']
のマンション	['助詞', '名詞']
アイテムを	['名詞', '助詞']
を進める	['助詞', '動詞']
おまけに	['名詞', '助詞']
どこから	['名詞', '助詞']
てしまうので	['助詞', '動詞', '助詞']
のときに	['助詞', '名詞', '助詞']
のうちに	['助詞', '名詞', '助詞']
と比較して	['助詞', '名詞', '動詞', '助詞']
誰にも	['名詞', '助詞', '助詞']
明日から	['名詞', '助詞']
のが一番	['名詞', '助詞', '名詞']
こともできます	['名詞', '助詞', '動詞', '助動詞']
の両方	['助詞', '名詞']
という思い	['助詞', '名詞']
たちも	['名詞', '助詞']
周辺で	['名詞', '助詞']
って思って	['助詞', '動詞', '助詞']
がかかって	['助詞', '動詞', '助詞']
